瑨	jbwo
辨	bmlu
辫	bmlu
瑾	jbwa
珒	jbwy
琎	jbwz
訄	qqjy
珐	faws
猱	ncqm
扒	pafb
倮	lorg
钼	mujo
峱	ncqe
熜	zshx
搠	uofo
孱	cjuz
惋	wjxv
磙	gyuy
硍	gyug
哏	gfkg
踶	dizr
疋	pivr
奓	uedx
滠	uedy
菍	rfcx
唸	nmkx
皮	pivy
荏	rfcr
貔	pivb
奢	uedo
鞣	rzgm
楗	jmmz
怯	qpxs
麑	nige
郄	qpxe
瞓	ffoi
槛	jmmm
税	uvhe
检	jmma
惬	qpxj
铻	wujk
刮	gxqd
舾	xivx
锄	iujl
磨	mogu
庥	xqgm
赝	yjir
筷	kkvn
旻	mbow
麽	mogm
靺	mogm
廑	qbga
钨	wujw
魔	mogg
习	xivd
合	herk
龢	herh
盒	herm
饵	erue
炟	dahd
郃	here
邿	uite
僚	lnrx
颌	herr
哌	pdkn
鲻	ziat
控	ksfg
庤	vigc
虍	hulq
髭	ziab
鳛	xiab
缑	gzsu
轩	xrig
螫	uiti
琰	yjwh
幌	hljw
锽	hljw
杳	ycmo
柙	xxmj
兖	yjwe
盏	vjjm
鳄	eeak
耠	holk
稌	tuhh
秃	tuhj
萄	tccf
婠	wank
囤	dykt
薮	szcw
鞘	ucgo
娃	want
硐	dsuk
染	rjdm
栟	bfmk
肜	rsop
猓	goqg
袆	hvpw
厩	jqiv
涩	sedv
芼	mccm
鄚	mcce
读	dzyd
茅	mccp
洓	sedn
蛘	yhiy
茂	mccw
辑	jiie
旮	gajo
虮	jiij
徛	jiik
钆	gajv
墼	jiit
燋	vohh
厢	xlio
蟓	xlin
崚	lkew
岭	lkes
聆	lkes
碌	luuu
灵	lkeh
焯	vohu
输	uuid
畜	iuwt
萳	njcg
醮	jnyh
衰	ukwy
舸	gevk
祠	cipk
饹	geuk
觱	bixy
馓	sjuw
愎	bixw
栓	urmw
尨	lsud
蜩	tnik
粜	tnim
瘳	izbp
闩	urma
脩	xqro
航	hhvj
涉	uedp
玠	jpwl
冠	grbc
铓	mhjw
缊	wfsm
胥	xuvo
官	grbk
箍	guvj
陷	xmej
醌	kyyb
往	whiv
辋	whiw
镂	lzjn
崄	xmea
限	xmeg
岘	xmee
懦	noxe
绀	gjsg
舱	chvv
耵	dked
蚋	rvin
秫	uuhu
痉	jkbg
垣	yrtg
忐	tjux
窨	ybbo
枰	pkmp
瑆	xkwu
寅	ybbb
瘾	ybbx
螠	yiim
撬	qnfm
涘	sidu
士	uiua
撇	ppfw
暶	xror
蚀	uiui
髑	dugi
饰	uiuj
倍	bwrk
瑭	thwk
鸤	uiun
汹	xsdk
透	tzzn
贳	uiur
度	dugy
摇	ycff
屘	miuz
噀	xykb
莼	iyct
婼	ronk
勒	legl
霆	tkyz
村	cymc
隹	vvrf
玷	dmwk
棣	ddmn
埒	lptc
辔	pwsk
嶂	vheu
灿	cjhe
鼹	yjjn
竹	vugg
垟	yhty
贴	tpkk
综	zssx
缒	vvsz
麈	vugv
	cjhp
纵	zssr
蚍	piib
飑	bnjs
啉	lbkm
题	tior
汴	bmdb
幖	bnjx
剔	tiod
卞	bmdx
蜱	piiu
呔	tdkt
镳	bnjh
飚	bnjh
拂	fuff
麸	fuff
拊	fufc
艴	fufb
写	xpby
酣	hjyg
弸	pggo
慊	qpxn
倩	qkro
枧	jmme
蘘	rhcy
媪	aonm
倾	qkrr
妫	gvnw
姽	gvnv
肘	vzoc
呪	vzoe
纼	vfsl
竣	jylw
床	ilgm
樽	zymc
凝	nkdr
禅	ujpl
蜷	qriv
辁	qriw
鸹	gxqn
酮	tsyk
泞	nkdd
姅	bjnb
衫	ujpp
镥	lujo
埆	jtty
柏	bomb
债	vdrr
黯	anho
奓	iidx
池	iidy
斶	iuji
鳙	ysal
摏	isfj
玥	ytwo
徐	xuih
玲	lkws
鸱	iidn
驳	bomx
侠	xxrj
弄	nswc
宴	yjbn
烙	lchk
欢	hryr
幻	hryv
酱	jldy
羹	ggyd
江	jldg
奖	jldd
裾	jupk
遏	eezv
桨	jldm
禔	tipr
糒	bwmy
椑	bwmu
綮	qihx
荸	bicz
铍	pijy
棨	qihm
杯	bwmb
申	ufll
肾	uflo
曲	qula
鹙	qqhn
潖	padb
秋	qqhh
蛃	bkib
瑙	ncwx
镐	hcjk
蒄	grcc
埙	xytr
隽	jrrn
倦	jrrv
鹳	grcn
烁	uohl
衮	gywy
痘	dzba
裁	cduy
逐	vuzu
躅	vuzi
璨	cjwm
瓢	pnxg
螽	vswi
敛	lmrw
坯	pitp
埤	pitu
衷	vswy
圮	pitj
葬	zhcc
毗	pitb
璺	wfpy
提	difr
霓	niye
蚱	vaiv
嵚	qber
缤	bbsb
尢	yzuv
慕	mucx
珝	xuwx
黜	iuhi
友	yzuy
幕	mucj
拦	ljfs
块	kktn
募	mucl
右	yzuk
乸	naym
稣	suah
茈	zicb
褐	hepv
佻	tnrd
毂	guuy
嘏	guuy
榖	guuy
鼒	zicv
笪	davd
隘	aiem
埵	doti
笆	bavb
答	davk
飘	pnxx
垛	dotm
鬷	zsaw
轾	viit
秸	jphk
鼋	yred
院	yree
娼	ihno
蜘	viik
咫	viib
轵	viib
砚	yjue
疴	kebk
曜	ycof
窠	kebg
研	yjuk
腰	ycon
玱	chwv
暇	xxoy
菲	fwcf
祜	hupk
芾	fwcl
潢	hldb
瞎	xxok
占	vjlk
瞽	guuo
馉	guuo
滉	hldw
鸪	guun
楪	dpmm
钘	xkjk
绵	mmsj
茎	jkcg
缅	mmsm
妥	topn
鞔	mjgv
酢	zoyv
葎	lvcy
睑	jmoa
歪	wdpv
暕	jmoj
腱	jmoz
饕	tckl
暕	ljoj
纂	zrvx
冬	dswd
砗	ieui
噇	ilkl
渟	tkdd
榕	rsmk
嫽	lnnx
啾	jqkh
脒	miom
瞇	miom
咳	hdkr
咍	hdkk
嗨	hdkm
咉	yhky
藟	lwct
哜	jikl
叽	jikj
咭	jikk
眍	kzox
戢	jikd
唧	jike
祊	bgpf
夬	gkvn
喟	kvko
岬	jxej
响	xlkk
库	kugi
骷	kugk
佽	cirr
奉	fgfl
泛	fjdf
庶	uugh
矗	iuuq
酆	fgfe
鼻	bizl
婤	vznk
础	iuui
跸	bizu
逼	bizt
氾	fjdv
伺	cirk
拱	gsfb
谘	ziyk
衰	cvwy
叕	liyy
稹	vfhb
弄	lswc
雳	liyl
醨	liyd
俸	fgrl
璀	cvwf
唷	yoko
醴	liya
届	jpuy
狠	hfqg
颉	jpur
碣	jpuv
癞	ldbr
劼	jpul
截	jpuf
垿	xutl
亡	whwv
望	whww
忘	whwx
圩	xuty
妄	whwn
漭	mhdc
莴	wocn
贾	guxr
橄	gjmw
闼	tamz
阘	tamx
柑	gjmg
拶	zjfx
攒	zjfr
挣	vgfl
飐	vjjk
拯	vgfa
褙	bwpo
鹎	bwpn
跋	bazd
榣	ycmf
卑	bwpu
桁	hgmi
碘	dmub
磹	dmuu
颠	dmur
	iyao
殿	dmuy
骞	qmbm
褰	qmby
搴	qmbu
噔	dgka
歉	qmbr
蒇	ijcr
桧	hvms
骓	vvmf
枱	tdmk
莶	xmca
梯	timp
跫	qsgr
苋	xmce
抃	bmfx
煋	xkhu
邛	qsge
蛩	qsgi
藓	xmcy
銎	qsgj
棣	timn
睥	piou
鳃	sdax
甜	tmqg
郭	gowe
邗	hjge
裹	gowy
舔	tmqx
赏	uhxr
裟	uady
倻	yere
裳	uhxy
挲	uadu
迫	pozb
煞	uadh
尚	uhxk
渰	yjdc
鲨	uada
逛	glzw
咄	doki
哚	dokm
哆	dokx
嬗	ujnd
姗	ujnc
瘛	iibx
布	buuj
薄	bocc
痴	iibk
菠	bocy
蕃	boct
迹	jizd
铹	lcjl
皛	xnbb
宵	xnbo
粿	gomg
拌	pjfb
辏	czit
侘	iarq
赓	gggr
倨	jurk
鹒	gggn
陛	biet
环	hrwb
俱	jurb
啮	npkk
皭	jnbc
蟹	xpdi
审	ufbu
渫	xpdm
解	xpdn
瘆	ufbp
嗫	npky
觟	xpdt
泄	xpdu
契	qifd
泻	xpdy
旗	qifb
揖	yife
巯	qqvv
挹	yifb
矜	jbsv
禀	bkwx
帕	pajb
旖	yifk
硇	ncux
柘	vemu
箩	lovx
麦	mdfw
逊	xyzx
贿	hvko
巡	xyzv
迅	xyzu
回	hvkk
咴	hvkh
喙	hvku
畹	wjtv
哕	hvkx
裣	lmpa
铄	uojl
噢	ookd
撺	crfi
娲	wann
颦	pbvu
攒	crfr
频	pbvr
喔	ookt
蒜	srcx
裢	lmpz
岳	ytqe
傕	jtrf
倔	jtri
鹧	vegn
嗪	qbkh
疆	jlga
喳	vakd
噙	qbkd
蹊	xizd
喋	vakm
吒	vakq
咋	vakv
息	xizx
疼	tgbd
妩	wunw
牾	wunk
凓	lidm
沥	lidl
浬	lidl
蔌	sucr
蔼	aicv
垯	datz
朝	vcuo
艾	aicx
澧	lida
祧	tnpd
苏	sucb
籽	zimz
颎	jsbr
梓	zimu
舵	dovb
蟛	pgip
吱	viky
侃	kjrv
龛	kjrl
只	vikb
姐	jpnq
婕	jpnr
鳐	ycaf
炆	wfhw
尧	ycaw
稳	wfhx
凸	tula
佗	torb
鲱	fwaf
骎	qbmy
侂	torq
昳	dpou
昪	bmoc
邸	dide
鳒	jman
吩	ffkd
涤	didm
滴	didk
梡	krme
浟	didw
氍	quom
鲣	jmat
栏	ljms
琉	lqwv
饹	leuk
榄	ljme
刘	lqwd
珋	lqwe
阑	ljmj
合	gerk
六	lqwb
婪	ljmn
痤	cobt
恚	hvtx
邨	cyte
藨	bnch
瘥	cobg
挺	tkfz
唓	ieki
鋆	yytj
敉	mimw
囷	qykh
杨	yhmp
邻	lbre
赍	jiur
屐	jiuy
疸	djbd
郸	djbe
戟	jiug
赁	lbrr
瘅	djbl
矶	jiuj
吉	jiuk
㗎	jxkm
馈	kvur
掉	dnfu
降	xlel
盔	kvum
啉	ljkm
劄	vavd
轻	qkig
珉	mbwm
霎	uayn
蜻	qkio
沨	fgdx
缞	uksy
隃	uued
浲	fgdf
忞	mbwx
冯	fgdm
玟	mbww
针	vfju
帧	vfjr
甾	zdvt
镇	vfjb
搊	izfp
涞	lddl
苕	ucck
焞	tyhz
述	uuzu
芍	uccu
蓑	socy
濑	lddr
熘	lqht
尪	whuw
紊	wfwx
忞	wfwx
玟	wfww
椓	vomn
孤	guzg
叙	xury
韫	wfwm
刎	wfwd
谭	tjyu
秾	nshn
昇	ugou
争	vgdl
丁	dkal
旰	gjog
晟	ugoi
嗒	takk
慢	mjxy
篾	mpvu
乜	mpvv
窍	qnbv
悗	mjxv
螃	phif
徬	phif
瞢	mgco
鹲	mgcn
飒	salx
试	uiyg
诗	uiyc
识	uiyb
蒙	mgcu
酾	uiyl
甍	mgcw
氘	dcql
璩	quwu
櫈	dgmj
肫	iyot
氚	irqi
朐	iyok
歹	ddax
吭	kgkj
嘞	lekl
茱	vucv
宓	fubb
粲	cjlm
餐	cjll
斧	fubj
苧	vucd
匐	fubt
丈	vhan
父	fubx
婊	bnny
肽	tdot
念	nmrx
嚏	tikr
啼	tikj
腮	sdox
鲜	xmay
蝰	kvit
胎	tdok
煸	bmhc
膦	lbol
纮	hsss
纡	yusy
兲	tmwb
预	yusr
鹬	yusn
馃	goug
予	yusl
镔	bbjb
崡	hjek
骛	wusm
婺	wusn
荮	vzcc
鄹	zzee
谇	svyu
宄	gvbj
啃	kfko
追	dvzk
陬	zzey
皈	gvby
焌	jyhw
蓠	licd
砼	tsug
杕	domd
权	qrmy
棬	qrmv
耍	uxen
酵	jnyz
烽	fghf
嫲	manm
蛳	siij
溟	mkdb
鲌	boab
厕	siid
洺	mkdk
膪	vdok
垵	antn
埯	antd
醉	zvyu
湴	pjdy
侉	kxrk
湛	vjdv
潘	pjdt
叚	xxvy
撸	lufo
掳	lufl
泮	pjdb
赑	bikr
访	fhyf
堞	dptm
趄	jutq
暲	vhou
垤	dptt
耿	ggeh
衩	iapi
弆	jutc
慬	qbxa
携	xpfn
挟	xpfj
玆	ziws
欹	qidr
砒	piub
揳	xpfd
陲	ivei
皤	pobt
漆	qidu
犺	khqj
觭	qidk
凄	qidn
洓	qidn
泣	qidl
柒	qidm
淇	qidb
撷	xpfr
魄	pobg
暿	xiok
潩	yidb
殪	yida
沂	yidj
漪	yidk
恂	xyxo
呶	ncky
溢	yidm
饼	bkuk
义	yidx
洢	yidy
恔	xnxx
阀	famg
绲	gysb
蛔	hvik
亘	gfad
猜	cdqo
舫	fhvf
毌	wjva
蟪	hvix
徽	hviw
郎	lhde
捧	pgfl
朗	lhdo
庖	pcgs
塱	lhdt
轫	rfir
竘	qulk
爵	jtpc
蔷	qlck
蔃	qlci
约	ytsu
闸	vamj
忾	xixq
欷	xixr
栅	vamc
楂	vamd
恓	xixx
郄	xixe
糅	rzmm
柤	vamq
惜	xixo
睦	muot
榨	vamv
柞	vamv
希	xixj
羑	yzyj
诱	yzyn
幼	yzyl
羞	xqyi
尤	yzyd
邮	yzye
枳	vimb
栉	vime
疬	libl
眦	ziob
骕	sums
痢	libd
植	vimq
桎	vimt
栀	vimv
梽	vimx
枝	vimy
疠	libw
鸻	hgin
竭	jplv
媆	rrnd
坎	kjtr
羱	yryx
堪	kjtv
骦	ulmo
墈	kjtl
耤	jplo
鸢	yryn
药	yccu
缎	drsy
缪	mqsp
馆	gruk
酽	yjyy
祖	zupq
酩	mkyk
谚	yjyp
谳	yjyq
坨	totb
瘫	tjbf
谶	ifyj
掊	pzfk
痰	tjbh
抔	pzfb
镬	hojy
锪	hojx
谌	ifyv
举	juxl
突	tubq
冕	mmov
眄	mmov
婞	xknu
	ybyj
锒	lhjl
逶	wwzn
霪	ybyr
蔓	mjcy
违	wwzw
眠	mmom
腼	mmom
蝶	dpim
实	uibd
菅	jmck
茧	jmci
蒹	jmcn
补	bupb
荐	jmcz
弟	dibp
箨	tovl
的	dibu
岣	gzek
酏	yiyy
叕	yiyy
谊	yiyq
硫	lquv
馏	lqut
碌	lquu
诒	yiyk
译	yiyl
诣	yiyo
	xbyj
赚	zrrk
授	uzfy
畚	bfst
礵	uluo
塞	sebt
圫	vytq
彻	ieid
蝾	rsim
寿	uzfc
奀	enbd
旸	yhop
鲼	ffar
讶	yayy
拚	pbfc
做	zorw
勒	lwgl
雅	yayf
势	uifl
鸦	yayn
缛	rusc
浐	ijdi
剂	jiwd
玑	jiwj
尿	nnuu
齑	jiwl
雌	civf
衠	vyii
汈	dndd
凋	dndk
倬	voru
蛱	jxij
箄	bivu
圊	qkko
蔬	uucv
胼	pmok
龈	kfvg
疯	fgbx
纹	wfsw
篦	bivb
舭	bivb
笔	bivm
箅	bivl
薯	uuco
煖	nrhy
瀍	ijdt
珺	jywk
浈	vfdr
恿	yssx
鸩	vfdn
溱	vfdh
喈	jpkb
梢	ucmo
潺	ijdz
柖	ucmk
恺	kdxj
忾	kdxq
絷	vifx
凇	ssds
杓	ucmu
须	xupr
萣	dkcr
爟	grhf
媭	xupn
郑	vgbe
倣	fhrw
戡	kjqg
傩	norf
寁	zjbr
络	lcsk
溵	ybdy
筠	yyvd
杈	iami
掾	yrfu
槃	pjvm
楂	iamd
槎	iamg
淫	ybdr
檫	iamx
剦	ybdd
樘	thmt
砬	laul
躯	quux
剌	laud
衡	hgii
读	duyd
项	xlgr
屈	quui
菱	lkcw
庠	xlgy
导	dcsc
扒	bafb
戥	dgog
醅	pwyk
霈	pwyl
瞪	dgoa
扦	qmfq
椀	wjmv
拑	qmfg
掮	qmfo
钗	idji
驻	vumv
株	vumv
廛	ijgt
堋	bgto
杼	vuml
槠	vumo
孵	fulz
术	vumd
柷	vume
翷	lbmx
祲	jbpy
耧	lzln
粼	lbmv
韬	tcwj
鲐	tdak
粦	lbml
苉	pice
芘	picb
翃	hsux
昔	xico
濒	bbdr
菡	hjck
蓰	xicr
坳	aotl
硔	hsub
葸	xicx
殡	bbdb
帚	vzej
括	gxfk
噂	zykc
龟	gvdv
碔	wuuv
屋	wuut
绻	qrsv
嵘	rsem
坂	bjty
缹	fzfh
卒	cuwu
钧	jyjd
蹙	cuwr
寐	mwbw
椿	iymo
昶	ihyo
鳋	scai
耀	ycxf
漉	ludb
判	pjbd
咝	siks
屎	uium
潞	ludk
肴	ycxo
砩	fuuf
澛	ludo
渌	ludu
盦	anrm
叛	pjby
爻	ycxx
嚯	hokf
嗣	sikk
嘶	sikj
弧	hugg
鹘	hugn
鹮	hrsn
龃	juvq
砢	louk
缳	hrsy
亢	khwj
堨	eetv
澹	djdk
栲	kcmv
淡	djdh
馔	vrub
狳	yuqh
狱	yuqq
懈	xpxn
砖	vruv
宧	yibl
益	yibm
鹢	yibn
俅	qqrq
迈	mdzw
逻	lozx
癔	yibx
疫	yiby
痍	yiby
肄	yiby
仇	qqrj
宜	yibq
疑	yibr
瘗	yibt
晖	hvoi
晦	hvom
茛	gfcg
杲	gcom
惙	ioxy
鄄	jrxe
丸	wjpd
斗	dzdu
妁	uonu
蔗	vech
镩	crji
憕	igxa
樾	ytmv
庸	ysgl
泂	jsdk
鄘	ysge
阅	ytme
栎	ytml
牚	igxy
筘	kzvk
眨	vaov
喾	kuxk
综	zgsx
棓	pzmk
价	jxrl
伽	jxrk
佳	jxrt
模	mumd
罾	zgso
洭	kldw
毪	mumn
假	jxry
篠	xnvm
薄	bccc
闭	bimc
褡	dapk
葆	bccm
苞	bccs
馌	yeum
镣	lnjx
诏	vcyk
辎	ziit
着	vcyo
胝	viod
袍	pcps
钌	lnjl
肢	vioy
膣	viot
捞	lcfl
疥	jpbl
淌	ihdk
岊	jpbe
琔	dmwr
皆	jpbb
璿	xrwo
瓘	grwf
瑄	xrwg
琯	grwk
鲴	guak
苍	chcv
恪	kexk
玄	xrwy
玹	xrwy
隃	yced
溷	hydu
悈	kexc
俎	zurq
璇	xrwr
璟	jkwx
帖	tpjk
塔	tatk
糯	nome
淜	pgdo
馊	szuy
璥	jkww
塌	tatx
泙	pgdp
癀	hlbb
惟	wwxf
画	hxak
咥	dpkt
鬘	mjay
刭	jkvd
喋	dpkm
棉	mmmj
驴	lvmh
榈	lvmk
梠	lvmk
鞲	gzgr
绑	bhse
谥	uiym
猥	wwqn
鬏	jqah
挖	wafv
搲	wafg
撮	cofy
麇	qygh
贲	bfur
挫	coft
措	cofo
搓	cofg
掌	vhxu
夐	xsdw
玡	yawy
鞮	digr
琊	yawe
惎	jiqx
缀	vvsy
瀼	nhdy
镨	pujo
镤	pujn
睡	uvoi
基	jiqt
铺	pujf
伞	sjru
鸟	nnwd
掸	djfl
期	jiqo
盷	tmod
担	djfd
喃	njkg
窎	dnbn
迺	ndzx
囡	njkn
果	goln
啱	njkk
鲛	jnax
稠	izhk
胛	jxoj
骈	pmmk
咽	yekd
匕	bipv
噎	yeka
骗	pmmc
返	fjzy
裉	kfpg
榱	cvmy
喝	yekv
叶	yeku
奈	nddx
束	uuan
毳	cvmm
仔	zdrz
吔	yeky
缗	mbso
揕	vffv
振	vffn
帱	izjc
抌	vffe
犸	maqm
颂	ssbr
骑	qimk
绺	lqsk
冉	rjla
栋	dsmd
罶	lqst
浆	jldu
抚	fufw
敷	fufw
咁	gjkg
踣	bozk
虒	sipj
祀	sips
跛	bozy
嘅	gekv
戭	yjbg
肮	ahoj
哼	hgkl
喳	iakd
嚓	iakx
崤	xneo
膛	thot
乇	vepq
鞔	mfgv
豪	hcwu
叇	ddez
钸	bujj
肋	leol
犷	glqg
诨	hyyi
璁	cswx
毫	hcwm
巉	ijed
瓀	rrwe
脘	wjoe
欠	qmdr
鹐	qmdn
潜	qmdo
浅	qmdj
汧	qmdk
钚	bujb
蹦	bgzo
瞩	vuoy
迸	bgzk
湖	hudo
苔	tdck
妇	fune
薹	tdct
瘭	bnbx
衽	rfpr
艚	ccvo
瘘	lzbn
鲏	piay
噻	sdkt
嘥	sdkv
嗮	sdkx
造	zczk
蹧	zczo
躁	zczm
母	muvd
禽	qbrd
卌	xial
摈	bbfb
尿	svuu
衾	qbry
鬶	gvfl
珷	wuwv
堨	yetv
鲰	zzay
粥	vzgg
郚	wuwe
吾	wuwk
珸	wuwk
务	wuwl
剡	ujhd
柔	rzsm
舨	bjvy
趑	zitr
煽	ujhx
猝	cuqu
宕	dhbu
殍	pndz
嵇	jihe
漂	pndx
浼	mwdv
沬	mwdw
湄	mwdo
渼	mwdd
洽	qxdk
镃	zijy
鑪	lujm
遥	yczf
淆	xndo
嶓	boet
楒	simx
卟	bukb
哺	bukf
潇	xnds
驷	sime
枱	simk
涍	xndz
洨	xndx
遐	xxzy
鲠	ggag
岵	huek
惧	juxb
獾	hrqf
腠	czot
俄	eerw
耩	jllr
深	ufdm
牒	dppm
嵲	npem
粝	limw
陧	npet
撮	zofy
食	sirl
颞	nper
渗	ufdp
聂	npey
捽	zofu
沈	ufdv
玒	hswg
尖	jmxd
瑑	vrwu
琟	yuwf
瑜	yuwd
躞	xpzy
育	yuwo
敔	yuww
瑀	yuwy
玙	yuwy
邂	xpzn
蹿	crzi
瓶	pkbw
陞	uget
耙	palb
臑	ncoe
糕	gcmh
槁	gcmk
逴	iozu
橞	hvmx
槥	hvme
杩	mamm
槔	gcmu
钭	dzju
链	lmjz
迎	ykze
镰	lmjn
赃	zhkt
窘	jsbk
颙	ysyr
噌	cgko
刖	ytod
逞	igzw
曱	ytol
玢	ffwd
鲊	vaav
棐	fwfm
檎	qbmd
肶	biob
翯	hexk
缜	vfsb
跳	tnzd
迢	tnzk
莎	socu
睥	biou
鲍	bcas
燎	lnhx
窳	yubg
嗞	ziky
娌	linl
呲	zikb
谨	jbya
兵	bkqb
晋	jbyo
蓇	guco
菇	guck
龌	wovt
菰	gucg
云	yyes
陨	yyer
碹	xrug
劣	lpul
靿	ycgl
詹	vjdk
倴	bfrc
惚	huxx
喏	nokk
探	tjfm
搒	pgff
摊	tjff
怙	huxk
陈	ifed
抨	pgfp
兢	jkue
曼	mjoy
熊	xssh
彰	vhlp
花	hxcb
瞒	mjol
吕	lvkk
籐	tgvu
黾	mmkd
稻	dchj
誓	uifk
鞯	jmgz
猊	niqe
拭	uifg
施	uify
熥	tghz
靬	jmgg
伽	qprk
嫐	ncnn
守	uzbc
奠	dmbd
兽	uzbk
迨	ddzk
逮	ddzn
敲	qnwy
甸	dmbt
癫	dmbr
首	uzbz
瘦	uzby
髋	krge
癜	dmby
榑	bomc
谦	qmyn
冇	mcuk
靡	migf
弭	mige
麋	migm
碣	yauv
柰	ndmx
弥	migx
縻	migx
砑	yauy
孪	lrwz
罽	jisd
缉	jise
脔	lrwr
殚	djdl
羁	jism
级	jisj
给	jisk
挛	lrwu
继	jisv
銮	lrwj
摁	enfx
绩	jisr
娈	lrwn
栾	lrwm
峦	lrwe
僰	bomr
瑖	drwy
穙	puhn
绰	icsu
楠	njmg
茭	jncx
锅	gojn
跐	cizb
槚	jxmr
帼	gojy
枷	jxmk
蕉	jnch
艽	jncj
浑	hydi
湣	hydo
藠	jncb
靥	yeim
脆	cvov
幢	vljl
桲	bomz
纱	uasu
俾	biru
蟀	ukiu
佖	birb
愁	izhx
晴	qkoo
童	tsll
孅	xmnj
玛	mawm
馨	xbuo
耦	ouly
铼	ldjl
胴	dsok
垲	kdtj
伺	sirk
嵊	ugen
盯	dkod
似	sirr
俬	sirs
俟	siru
腚	dkor
偲	sirx
鼎	dkov
嫚	mjny
珖	glww
牥	fhnf
疤	babb
诎	quyi
辽	lnzl
悖	bwxz
葙	xlco
虻	mgiw
蠓	mgiu
螳	thit
螗	thik
芗	xlcx
蜢	mgim
胖	phob
膀	phof
巷	xlcs
蟒	mgic
广	glwp
亮	llwj
蓏	locg
隼	syru
琶	pawb
荦	locn
扎	zafv
萝	locx
拶	zafx
陪	pwek
蹽	lnzx
蠋	vuii
厕	ceid
蛀	vuiv
啴	ijku
坠	vvet
蜿	wjiv
瑧	vfwh
绦	tcsm
馥	fuhw
仁	rfre
绹	tcsf
稃	fuhz
仞	rfrr
缙	jbso
闷	mfmx
瀌	bndh
硕	uour
忍	rfrx
拆	idfi
慥	zcxz
跄	qlzv
涴	wodv
垌	dstk
袄	aopy
席	xigj
貉	movk
蕨	jtcr
貘	movd
堆	dvtf
觋	xige
坶	mutm
璲	svwz
丌	jial
掠	ltfx
枨	igmi
恶	wuyx
误	wuyt
诬	wuyr
寡	gxbd
诌	vzye
雾	wuyl
酎	vzyc
洚	jldl
冑	vzyo
傉	nurc
衄	nvxi
版	bjpy
掸	ujfl
訾	zivk
掞	ujfh
忒	teyx
擅	ujfd
瑔	qrwu
龇	zivb
觜	zivy
紫	zivx
佞	nkrn
统	tsse
笫	zivp
赀	zivr
唇	iyik
蝽	iyio
圌	irke
稑	luht
销	xnjo
穋	luhp
虓	xnjj
秒	mnhu
霑	vjyk
庀	pigb
拤	qxfb
冥	mkbb
虏	luhl
掐	qxfj
炉	luhh
遽	juzu
葫	huco
酴	tuyh
踽	juzy
垮	kxtk
锼	szjy
荡	dhcp
徵	viiw
菪	dhcu
谎	hlyv
踞	juzk
距	juzj
佚	dpru
糵	npcm
蘗	npcm
纺	fhsf
孽	npcz
磉	shum
馀	yuuh
镑	bhjf
晗	hjok
趼	jmzk
践	jmzj
旰	hjog
尉	yuuc
讧	hsyg
郁	yuue
启	qihk
饫	yuuy
建	jmzy
踺	jmzz
嫕	yinx
姨	yiny
泙	pkdp
涄	pkdv
洴	pkdk
郇	xybe
淜	pkdo
冯	pkdm
窨	xybo
呗	bdkr
忒	tvyx
荟	hvcs
茴	hvck
谴	qmyz
缟	gcsk
慑	uexy
腍	rfox
蕹	wgcf
蓊	wgcx
炼	lmhd
澂	igdw
铷	rujk
尬	gayl
镢	jtjr
澄	igda
爚	ythc
绣	xqsn
莜	yzcw
摴	iufk
莸	yzcy
焯	ichu
搐	iuft
堀	kuti
莠	yzcn
郦	lile
篇	pmvc
撂	lnfk
盆	pfbm
鹂	liln
皿	mbla
讽	fgyx
彼	biiy
撩	lnfx
淮	hkdf
垱	dhte
贰	eryr
置	visq
纸	visu
拮	jpfk
织	visb
捷	jpfr
挦	xmfc
揭	jpfv
絜	jpfx
缘	yrsu
岑	cfev
闹	ncmj
筲	ucvo
桡	ncmw
矜	grsv
芸	yycs
翾	xrsx
菀	yycv
搌	vjfn
纶	grsb
蕰	yycm
旃	vjfd
绚	xrso
潭	tjdu
祂	tapy
褟	tapx
滩	tjdf
涂	tudh
祸	hopn
澹	tjdk
铊	tojb
洈	wwdv
苟	gzck
貊	movb
雄	xsuf
潍	wwdf
渭	wwdo
洧	wwdo
縯	ybsb
趄	qptq
湜	uidr
朔	uobo
湿	uidy
缸	ghfg
帱	dcjc
棻	ffcm
玤	bhwf
辣	lalu
浉	uidj
芬	ffcd
誊	tgjk
婷	tknd
茸	rsce
酿	nlyl
蓉	rsck
荣	rscm
闰	rymw
扂	dmhk
锉	cojt
袤	mcwy
阳	yhey
瑁	mcwo
穑	sehk
玞	fuwf
浃	jxdj
铪	hajk
泇	jxdk
琈	fuwz
韨	fuwy
藻	zccm
焜	kyhb
坷	ketk
短	drua
遴	lbzl
躏	lbzf
扑	pufb
疙	gebq
肫	vyot
煃	kvht
腩	njog
割	gebd
峤	jnel
蹯	fjzt
龚	gslb
腋	yeon
婤	iznk
鲭	qkao
晌	uhok
晔	yeou
跤	jnzx
赉	ldlr
窊	wabg
岚	ljex
哨	ucko
燃	rjhh
码	maum
酪	lcyk
醪	lcyp
绿	lusu
卒	zuwu
扰	rcfy
餸	ssrz
脎	saom
胯	kxok
廾	gsal
珇	zuwq
锹	qnjh
投	tzfy
耙	balb
挲	sadu
潵	sadw
洒	sadx
瀔	gudy
羚	lkys
蘩	fjcx
珀	powb
鳑	phaf
酃	lkye
辌	llix
磴	dgua
辆	llil
蟾	ijik
蝉	ijil
残	cjdj
跟	gfzg
贮	vuka
盉	hehm
嘱	vuky
跦	vukv
掺	ujfp
锘	nojk
酰	xmye
摽	bnfx
荑	ticy
幅	fujt
桃	tcmd
霰	xmyw
褊	bmpc
陂	piey
陴	pieu
祕	bipb
壸	kyuy
陉	xkeg
啻	iiwk
揩	kdfb
漦	iiwu
墙	qltk
溉	gddv
搂	lzfn
墨	moht
仫	murm
隙	xiex
巇	xieg
酅	xiee
嶍	xieb
秣	mohm
隰	xieh
靼	dagd
谤	bhyf
伴	bjrb
跪	gvzv
隋	doeo
堕	doet
隳	doex
鞑	dagz
煤	mwhm
自	zipo
捺	nafx
笮	zevv
堨	aitv
埃	aitu
汕	ujde
潸	ujdo
燘	mwhw
燐	lbhl
雱	phyf
瑃	iywo
鹑	iywn
熇	xnhk
掞	yjfh
揞	yjfo
艳	yjfb
掩	yjfd
墓	muct
娥	eenw
挈	qpfu
鳠	huay
梗	ggmg
烱	jlhk
互	huaa
苜	muco
桓	hrmg
姶	eenk
侣	lvrk
偻	lvrn
岫	xqey
慎	ufxb
槌	ivmz
阚	hjmw
墣	putn
抆	mffw
邠	bbbe
翂	ffxd
吁	yuky
圉	yukg
傲	aorw
喐	yuke
喻	yukd
愤	ffxr
圄	yukk
伎	qiry
翊	yilx
毅	yily
惠	hvax
龊	iovr
耄	mclm
啬	seuk
嬛	xrny
孩	hdzr
茽	vscv
浮	fudz
爝	jthc
辄	veiv
辙	veiw
叆	aiey
燋	jthh
哕	ytkx
妳	ninx
晡	buof
抢	igfv
撑	igfu
芨	jicj
黐	iihs
貂	dnvk
炽	iihb
刺	ciad
滁	iudh
触	iudi
雏	iudf
鲉	yzay
钞	icju
濋	iudr
哔	biku
鹩	lndn
跶	dazz
疏	uuvv
泷	lsdl
锂	lijl
挑	tnfd
潦	lndx
鄙	bike
咇	bikb
租	zuhq
涸	hedk
达	dazd
书	uuvd
漻	lndp
隺	hedf
解	jpdn
支	viuy
洁	jpdk
直	viuq
疐	viur
湝	jpdb
知	viuk
智	viuo
雉	viuf
楷	kdmb
遁	dyzo
蹲	dyzc
芴	hucw
蹾	dyzw
悬	xrqx
町	dktd
伙	horh
佸	hork
獍	jkqe
货	horr
猄	jkqx
鹘	gugn
雀	qnuf
擤	xkfl
壳	qnuj
肚	duot
硚	qnul
锬	tjjh
硗	qnuw
钽	tjjd
狺	ybqk
划	hxgd
痿	wwbn
氤	ybqd
矰	zguo
迪	dizy
彭	bhup
递	dizp
港	ghds
蹢	dizk
遆	dizj
尼	niub
箧	qpvj
铈	uijj
喏	rekk
冮	ghdg
镴	lajv
磅	bhuf
掂	dmfk
烃	tkhg
融	rsai
捵	dmfb
靛	dmfr
垫	dmft
菍	npcx
猫	mcqt
仉	vhrj
猰	yaqd
氩	yaqy
仗	vhrv
鞅	yhgy
铯	sejb
浦	pudf
溥	pudc
暵	hjon
潽	pudo
濮	pudn
氟	fuqf
瀑	pudu
溴	xqdq
谁	uvyf
锟	kyjb
懔	lbxx
瘟	wfbm
漷	kode
猎	lpqo
倭	worn
枣	zcad
偓	wort
掴	gofy
檠	qkcm
歌	gedr
苘	qkck
擎	qkcu
啐	cvku
繁	fjpx
番	fjpt
禳	rhpy
椰	yeme
楪	yemm
烔	tshk
戙	dskg
咚	dskd
酦	poyy
沆	hhdj
百	bdab
夯	hhdl
骝	lqmt
柳	lqme
躜	zrzr
巳	sivv
圣	ugyt
干	gjau
鳡	gjax
啶	dkkr
丝	siva
鸶	sivn
叮	dkkd
司	sivk
笥	sivk
嵖	iaed
蝇	ykid
苣	jucj
蒟	juck
礓	jlua
菊	jucm
燋	qnhh
苴	jucq
颈	ggvr
独	duqi
钫	fhjf
唛	makw
檬	mgmu
乇	topq
撒	safw
卬	ahpe
膳	ujok
憨	hjvx
铴	thjp
栊	lsml
砫	vuuv
属	vuuy
顽	wjer
旵	ijoe
铏	xkjd
掺	cjfp
莺	ykcn
萤	ykci
荧	ykch
营	ykck
蓥	ykcj
赭	veto
鳀	tiar
螫	veti
涊	nmdx
莹	ykcy
萦	ykcx
荥	ykcu
茔	ykct
牂	zhpy
瘥	idbg
庵	angd
饬	iiul
尺	iiun
坡	poty
漏	lzdy
钙	gdjg
鞍	angn
蕙	hvcx
珫	iswe
溇	lzdn
恤	xuxx
翅	iiux
改	gdjw
敕	iiuw
琨	kywb
噏	xikx
缞	svsy
锊	ltjc
绥	svsn
吸	xikj
唏	xikj
嘻	xikk
昃	zeor
籼	xmme
度	dogy
招	vcfk
镅	mwjo
矼	ksug
仔	zirz
镁	mwjd
旐	vcfd
莰	kjcr
疝	ujbe
单	ujbl
郐	gvre
璒	dgwa
猖	ihqo
笋	syvy
卤	lulx
繇	ycpx
湮	yjdt
姣	xnnx
颅	lulr
卢	lulu
铉	xrjy
鹞	ycpn
罪	zvsf
蹒	pjzl
奄	yjdd
剦	yjdd
舀	ycpj
鸬	luln
夭	ycpd
漹	yjdh
燄	yjdh
沿	yjdk
杄	qmmq
圜	hrky
殷	ybpy
昒	huow
哽	ggkg
磺	hlub
唤	hrkd
血	xppm
圌	ivke
颡	shyr
迄	qizq
踦	qizk
尻	kcuj
褛	lvpn
蹊	qizd
佩	pwrj
	hjkw
滘	jndk
喊	hjkk
蝓	yuid
蜮	yuia
廆	hvgg
麾	hvgm
鬲	geal
璱	sewb
儡	lwrt
膏	gcwo
海	hddm
赦	uetw
逡	qyzw
抉	jtfn
掘	jtfi
驵	zhmq
㗎	gakm
啫	veko
攫	jtfy
嗻	vekh
撅	jtfr
降	jlel
拏	nanu
嬬	rune
臻	vfah
珙	gswb
茈	cicb
跏	jxzk
麀	yzgb
躇	iuzo
耖	iclu
琇	xqwn
茨	cicr
寥	lnbp
黧	lihh
砜	fgux
炮	pchs
犁	lihn
偏	pmrc
利	lihd
惮	daxl
陑	eree
戾	lihq
黎	lihu
怛	daxd
瑗	yrwy
逑	qqzq
讼	ssys
忳	dyxt
诵	ssyy
遒	qqzy
惇	dyxz
馁	nwun
镒	yijm
钇	yijv
靳	jbgj
镱	yijx
铱	yijy
鼽	qqzj
廑	jbga
晨	ifon
鸵	tonb
景	jkox
顾	guir
瞋	ifob
蛊	guim
胫	jkog
蛄	guik
晶	jkoo
腈	jkoo
肼	jkoj
抬	tdfk
惺	xkxu
缲	qnsm
珢	ybwg
悻	xkxg
兴	xkxb
郯	tjhe
捣	dcfe
捯	dcfd
尐	dixd
翟	dixf
焘	dcfh
爪	vxpn
讻	xsyk
纛	dcfx
	kkfk
裤	kupi
炻	uihu
赠	zgko
淀	dmdr
汆	crru
铤	tkjz
酂	cone
谑	xtya
睚	yaot
缱	qmsz
雪	xtye
醚	miyz
矛	mcsp
恙	yhyx
羕	yhyy
纤	qmsq
谧	miym
醾	miym
囵	lykb
铟	ybjd
瞀	mcso
养	yhyl
鸯	yhyn
畿	jiyt
匍	pubf
煓	trhe
绋	fusf
绂	fusd
罘	fusb
缚	fusc
讥	jiyj
诘	jiyk
霁	jiyl
鸡	jiyn
露	lzyk
昀	yyod
温	wfdm
佃	tmrt
汶	wfdw
牁	kepk
弍	erye
崔	cvef
或	hoga
涡	godn
崒	cveu
腌	aaod
砂	uauu
郡	jyye
嗉	sukx
君	jyyk
戆	vllx
雠	izrf
俦	izrc
榀	pbmk
犨	izrn
仇	izrj
峒	dsek
岽	dsed
排	pdff
脬	pcoz
铜	tsjk
缥	pnsx
蹓	lqkt
谰	ljyj
徘	pdif
憕	vgxa
璐	luwk
浓	nsdn
绡	xnso
六	luwb
堋	pgto
怔	vgxv
崂	lcel
苷	gjcg
伯	borb
趱	zjtr
测	cedd
岠	juej
崌	juek
埂	ggtg
聚	juen
绛	jlsl
缰	jlsa
茶	iacm
苴	iacq
茬	iact
岨	jueq
圻	qitj
痺	bwbu
盟	mgom
蘧	qucz
房	fhhf
棽	ufmv
蘅	hgci
蕖	qucm
朦	mgou
曚	mgou
矇	mgou
苣	qucj
唐	thgk
婫	hynb
详	xlyy
轿	jnil
铫	dnjd
垾	hjtg
铞	dnjj
婚	hyno
搁	gefk
钓	dnju
蛟	jnix
徼	jniw
椋	llmx
螺	loix
粮	llml
珠	vuwv
惨	cjxp
鹊	qtcn
棬	jrmv
邀	yczw
阐	ijml
惭	cjxj
馅	xmuj
燹	xmuh
戕	qlpg
捻	nmfx
霹	piyu
亹	mfwq
襁	qlpi
奘	zhvd
硍	xmug
辇	nmfi
撚	nmfh
拈	nmfk
献	xmuq
捵	nmfb
砉	xufu
岸	aneg
堠	hztu
螅	xiix
徙	xiir
锈	xqjn
耱	molu
蜥	xiij
熙	xiih
喹	kvkt
劝	qryl
匮	kvkr
钠	najn
醋	cuyo
镎	naju
荙	dacz
酢	cuyv
醛	qryw
椽	irmu
沼	vcdk
嵁	kjev
飧	syxl
籥	ytvc
邓	dgye
摒	bkfk
纯	iyst
鞧	qqgy
崮	guek
孝	xnlz
璜	hlwb
肓	hlwo
瘕	xxby
侥	ycrw
炫	xrhy
烜	xrhg
瑝	hlww
患	hrix
糠	khmn
齉	nhzy
闶	khmj
槲	humu
楛	humk
缨	yksn
糊	humo
谠	dhye
偕	xprb
筌	qrvw
偰	xprd
崴	wden
斜	xpru
腴	yuoy
坟	fftw
铌	nijb
裥	jmpo
昱	yuol
坋	fftd
虷	hjig
黇	tmck
魅	mwgw
翙	hvex
坌	bfbt
堕	hvet
歙	uerr
狻	srqw
畬	uert
帘	lmbj
佘	uerx
烺	lhhl
累	lwtx
硊	wwuv
瀱	jidd
觖	jtdn
殛	jida
脊	jido
鹡	jidn
济	jidl
觭	jidk
奇	jidk
汲	jidj
宬	igbi
激	jidw
角	jtdy
洎	jidz
急	jidx
漈	jidx
骒	kemg
嫑	mqbn
柯	kemk
蔀	buce
溺	nndd
憷	iuxr
鄃	uure
怵	iuxu
贾	jxxr
舒	uurl
毹	uurm
倏	uurq
雹	bcys
躬	gsug
馐	xqui
悆	uurx
缝	fgsz
酯	viyo
堎	lgtw
嗦	sokx
唆	sokw
卧	woib
唢	sokr
识	viyb
髀	bigu
嗍	soko
抿	mbfm
篱	livd
珑	lswl
庇	bigb
隶	livn
篥	livm
貍	livl
窕	tnbd
弼	bigg
蠡	livi
腿	tvoz
悈	jpxc
桀	jpxm
浔	xydc
潠	xydb
燚	yihh
熠	yihb
洵	xydo
兔	tudd
汛	xydu
黟	yihx
扅	yihx
扆	yihy
帡	pkjk
埋	mdtl
榇	ifmm
趿	tazj
踏	tazo
郴	ifme
遝	tazs
粳	jkmg
绯	fwsf
遢	tazx
梣	ifmv
精	jkmo
沩	wwdw
涠	wwdw
溦	wwdw
娓	wwnm
硍	ybug
哗	hxku
饮	ybur
蛮	mjwi
始	uink
诟	gzyk
笛	divy
镀	dujy
第	divp
茁	voci
诈	vayv
著	voco
奎	kvdt
溃	kvdr
浍	kkds
幽	yzey
袋	ddry
贷	ddrr
钿	dmjt
炮	bchs
熜	cshx
傣	ddru
黛	ddrh
圢	tktd
鹾	colg
岱	ddre
禅	ijpl
桠	yamy
襜	ijpk
惴	vvxe
鸟	dnwd
轮	lyib
遆	tizj
逖	tizh
泖	mcde
拐	gkfl
呱	gukg
揾	wffm
观	grye
殖	uidq
咕	gukk
婫	kynb
糟	zcmo
汪	whdw
抆	wffw
嗄	uakw
唦	uaku
墦	fjtt
畈	fjty
庆	qkgd
穟	svhz
穗	svhx
页	year
唼	uakn
庼	qkgr
南	njug
隧	svez
柏	bdmb
甄	vfxw
裯	izpk
奭	uidb
猸	mwqo
彤	tsdp
潼	tsdl
沤	oudx
俫	ldrl
漋	lsdu
攥	zrfx
筝	vgvl
簪	zjvo
猇	xnqj
硵	luux
政	vgvw
嘬	zoky
盎	ahym
啜	ikky
鞠	jugm
鞫	jugk
侧	vdrd
浚	jydw
獴	mgqu
庞	phgl
放	fhfw
宋	ssbm
督	duuo
粕	pomb
蠹	duui
邡	fhfe
猛	mgqm
钯	bajb
馘	goba
含	hjrk
訇	hsbk
谼	hsbb
畔	pjtb
嚼	jnkc
叫	jnkl
颔	hjrr
涴	yrdv
噍	jnkh
宏	hsbs
今	jbrv
啰	lokx
咯	lokk
朘	jrow
豌	wjav
鬃	zsax
啕	tckf
叨	tckd
棤	qtmo
吮	uyke
唞	tcku
助	vuql
橥	vuqm
猪	vuqo
阕	qtmt
琼	qswx
笾	bmvz
阙	qtmr
纤	xmsq
褚	vepo
缐	xmsu
函	hjlk
褶	vepb
戗	qlrg
线	xmsj
膺	ykgo
鹰	ykgn
扳	bjfy
溆	xudy
洫	xudx
浒	xudw
侯	hzru
湑	xudo
戤	gdng
缲	scsm
袯	bopy
武	wuav
秀	xqhn
铦	gxjk
黉	hsxb
兀	wuae
五	wuaa
鹉	wuan
鬼	gvps
嫒	ainy
唰	uxkd
轷	huih
妹	mwnw
畅	ihup
媚	mwno
刊	kjgd
媒	mwnm
媄	mwnd
钊	vcjd
量	llol
乒	pkqp
唛	mdkw
冰	bkdu
晾	llox
笯	nuvy
呼	hukh
唬	hukj
妃	fwnj
旋	xrfr
囫	hukw
唿	hukx
揎	xrfg
彟	hoey
蹀	dpzm
裒	pzwy
侁	ufre
歧	qivy
伸	ufru
迭	dpzu
棫	yuma
剑	jmrd
俭	jmra
榆	yumd
僭	jmro
牮	jmrn
勃	boul
呙	wdkn
专	vrad
喎	wdkk
驭	yumy
健	jmrz
嫫	mond
曦	xiod
糙	ccmz
晞	xioj
睎	xioj
嬷	monm
腊	xioo
覃	qbxu
槽	ccmo
懊	aoxd
膝	xiou
肸	xiou
奔	bfdc
怍	zoxv
锚	mcjt
裇	uepx
社	uept
铆	mcje
兜	dzpe
帽	mcjo
嗡	wgkx
拼	pbfk
挤	jifl
烱	jshk
寇	kzby
氮	djqh
掎	jifk
甬	yssy
丞	igla
技	jify
勇	yssl
煨	wwhn
瞌	keom
剡	yjhd
铭	mkjk
扩	kofg
炎	yjhh
焱	yjhh
扊	yjhh
焰	yjhj
虤	yjhj
甗	yjhw
垚	yctt
筼	yyvr
磐	pjvu
爿	pjvp
烻	yjhz
鲕	erae
耳	eraa
泯	mbdm
湣	mbdo
忳	vyxt
鹔	susn
鲾	biat
褒	bcwy
癃	lsbu
坜	litl
荩	jbcd
𩠌	ssut
墩	dytw
蔊	hjcg
乙	yivv
簃	yivx
舣	yivy
彝	yivc
嗔	ifkb
峧	jnex
仃	dkrd
狒	fwqf
臣	ifkl
吟	ybkv
蔑	mpcu
屘	mjuz
馒	mjuy
吲	ybky
丏	mmav
骅	hxmu
喑	ybko
嚚	ybkk
史	uiln
师	uilj
埞	ditr
黩	duhd
恒	hgxg
坻	ditd
墑	ditk
呦	yzkl
囿	yzko
揆	kvft
艇	tkvz
歃	uaqr
哑	yaky
吖	yaky
章	vhlu
鄣	vhle
悌	tixp
先	xmne
惕	tixw
飙	bnqx
嫌	xmnn
娴	xmnm
噪	zckm
唣	zckq
嘣	bgko
椴	drmy
儴	rhry
梏	gumk
钕	nvjn
郧	yyke
脟	lpoc
栝	tmmk
嶦	ujek
厦	uaiw
请	qkyo
商	uhwk
缶	fzwk
峻	jyew
痊	qrbw
睁	vgol
泉	qrbu
败	bdkw
忳	tyxt
筹	izvc
丑	izva
捅	tsfy
阪	bjey
崶	fgec
脲	nnou
鄯	ujye
东	dsad
善	ujyk
埭	ddtn
疹	vfbp
骻	kxgk
效	xnww
瀣	xpdj
悲	bwfx
饷	xluk
瓿	bulw
珛	xqwo
蝎	xpiv
辈	bwfi
揹	bwfo
辚	lbil
祭	vdpx
铬	gejk
隩	aoed
鸿	hsdn
镉	gejl
啊	aakk
洪	hsdb
椒	jnmy
傈	lirm
浲	hsdf
嗄	aakw
刁	dnva
泓	hsds
吖	aaky
骄	jnml
纻	vusa
莞	wjce
腙	zsox
蔓	wjcy
菀	wjcv
芄	wjcw
顸	hjgr
阇	uemo
啸	xnks
陶	tcef
忭	bmxb
鼗	tcey
嘚	dekc
嘐	xnkp
郈	hzpe
狝	xmqx
县	xmqs
垕	hzpt
氙	xmqe
猃	xmqa
簿	bovc
箔	bovb
剥	bovd
怖	buxj
簸	bovy
嫂	scny
镌	jrjn
芴	wucw
绉	vzse
刽	gvrd
傀	gvrg
惝	thxk
纣	vzsc
罢	bass
伾	pirp
娜	nane
楞	lgmf
妠	nanr
肇	vchy
棱	lgmw
妧	yrne
媛	yrny
嫄	yrnx
衎	kjii
艽	qqcj
萩	qqch
偌	rork
恼	ncxk
病	bkbb
骆	lomk
邴	bkbe
蠲	jrbi
薅	hccc
椤	lomx
蒿	hcck
胚	pwop
蝴	huio
泫	xrdy
凼	dhuk
龀	ifvb
酡	toyb
漩	xrdr
低	dird
峘	hreg
夥	hogx
渲	xrdg
砀	dhup
神	ufpu
埼	qitk
坐	zort
泽	zedl
佐	zorg
畦	qitt
寺	sitc
睏	kyom
薁	yucd
睇	diop
萸	yucy
蓣	yucr
樨	ximn
思	sitx
析	ximj
遨	aozw
阋	xime
皙	ximb
茄	qpck
妮	ninb
嘈	ccko
粞	ximx
檄	ximw
婥	ionu
讳	hvyw
瑳	cowg
害	hdbk
诲	hvym
诙	hvyh
羔	gcyh
诰	gcyk
仑	lyrb
墕	yjth
埌	lhtl
杻	nqmi
篼	dzve
溽	rudc
濡	rude
岛	dcpe
洳	rudk
汝	rudn
亶	djwd
蜃	ufii
轲	keik
描	mnft
妍	yjnk
嫣	yjnh
嬿	yjnh
罅	xxfh
蚊	wfiw
缫	scsg
绽	vjsr
筛	udvj
袷	qxpk
幺	ycvs
蝌	keiu
壑	helt
姝	uunv
贺	helr
涮	urdd
嬥	tnnf
恕	uunx
婌	uuny
冧	mbbm
睃	soow
饱	bcus
荜	bicu
萆	bicu
鍪	mzsj
牟	mzsn
种	ishv
砻	lslu
垄	lslt
擞	szfw
俚	lirl
缪	mzsp
聋	lsle
例	lird
俐	lird
恨	hfxg
槿	jbma
禁	jbmx
圯	yits
埸	yitw
娉	pknv
凯	kdej
燻	xyhh
剀	kded
拓	tafu
贪	tjrr
黾	mgkd
糌	zjmo
挞	tafz
辰	ifin
沱	todb
怗	tpxk
倓	tjrh
缦	mjsy
帏	wwjw
彀	gzuy
帷	wwjf
蚓	ybil
姤	dunk
什	uiru
妒	dunh
棠	thxm
似	uirr
瘌	labd
㓥	thxd
戆	ghlx
犊	dund
惹	recx
侍	uirc
使	uirl
食	uirl
籴	dirm
筐	klvw
蚴	yzil
晫	voou
僬	jnrh
鹪	jnrn
蝣	yziz
迍	vyzt
蚰	yziy
侥	jnrw
佼	jnrx
嘡	thkt
葧	bocl
淙	csdx
磏	qmun
衙	yaii
轧	yaiv
乾	qmuq
讣	fuyb
黻	fuyd
黼	fuyf
幛	vhju
帐	vhji
靴	xtgb
蚤	zcii
虿	idwi
蚌	bgif
贤	xmlr
径	jkig
艿	ndcn
幄	wojt
臌	guoy
畤	iztc
圳	vfti
穰	rhhy
撞	vlfl
轨	gvij
佧	karb
濉	svdf
畛	vftp
苧	nkcd
靽	bjgb
籁	ldvr
麇	jygh
铽	tejx
陆	lqej
董	dscv
缆	ljse
畖	watg
怄	ouxx
珊	ujwc
玖	jqwj
咎	jqwk
鹫	jqwn
	wokn
杧	mhmw
艏	uzvz
收	uzvw
甪	luyy
露	luyk
	ssfy
硝	xnuo
咀	jukq
娶	quen
呻	ufku
膪	ikok
取	quey
岖	quex
巨	juka
哂	ufkx
绫	lksw
瓖	xlwy
礞	mguu
享	xlwz
叶	xpku
砦	vdvu
珦	xlwk
尨	mgud
胶	jnox
铑	lcjb
鏖	aogj
廒	aogw
哿	gelk
脚	jnoe
鹃	jrkn
皋	gcbu
粽	zsmx
砩	fwuf
枞	zsmr
嵬	wweg
隗	wweg
圈	jrkv
郢	ykke
罂	ykkf
罴	pish
德	deix
鹦	ykkn
嘤	ykkn
纰	pisb
赊	uekx
遍	bmzc
边	bmzl
罢	piss
镛	ysjl
嫱	qlnk
乘	ugqn
荖	lccb
嗻	vukh
劳	lccl
剩	ugqd
落	lcck
胺	anon
暗	anoo
圭	gvtt
劾	hewl
阢	wuew
峿	wuek
邽	gvte
碡	vzum
锿	aijy
愕	eexk
孖	zizz
衲	napn
鹨	lqxn
孜	zizw
萃	cvcu
耶	yeee
徜	ihik
脶	loon
屏	pkuk
巽	xysb
乏	fapv
脉	mdoy
葩	pacb
鳅	qqah
揭	qifv
屠	tuuo
忽	huwx
土	tuua
珰	dhwe
荁	hrcg
萑	hrcf
镄	fwjr
瑚	huwo
趁	iftp
琥	huwj
琟	wwwf
责	zefr
俟	qiru
企	qirv
晟	igoi
祚	zopv
玮	wwww
亹	wwwq
愐	mmxm
择	zefl
篯	jmvj
邦	bhfe
杕	dimd
颛	vrer
份	ffrd
棣	dimn
箭	jmvd
螬	ccio
彧	yuad
与	yuaa
偾	ffrr
鲗	zwad
熨	yyuh
细	xist
猯	trqe
瘼	mobd
羡	xmyr
绤	xisk
矬	cout
疮	ilbv
梼	tcmc
鲥	uiac
磋	coug
验	yjma
奁	lmdx
涟	lmdz
镭	lwjt
贫	pbbr
潋	lmdw
旄	mcfm
殓	lmda
蚣	vsis
滦	lrdm
筤	lhvl
秤	ighp
疾	jibu
嶒	cgeo
程	ighw
称	ighx
壅	yswt
饔	yswl
坰	jstk
寄	jibk
瘠	jibo
雍	yswf
趷	kekq
咳	kekr
宣	xrbg
渺	mndu
展	vjun
钶	kejk
煆	xxhy
痃	xrby
匼	kekk
嗑	kekm
䶮	yjlt
蹁	pmzc
囗	wwla
墅	uult
黾	mbkd
枫	fgmx
梵	fjmf
樊	fjmd
礼	lipv
溲	szdy
桫	somu
梭	somw
介	jprl
借	jpro
隆	lseu
窦	dzbd
罱	ljsg
耗	hclm
偈	jprv
蒈	kdcb
攉	hoff
盾	dypo
倘	thrk
伊	yiry
仪	yiry
偯	yiry
仡	yirq
佚	yiru
亿	yirv
塆	wjtg
倚	yirk
佁	yirk
食	yirl
佾	yiro
拖	tofy
嶲	xiev
溻	tadx
拓	tofu
弑	uixg
哪	neke
袒	tjpd
吠	fwkq
呐	nekn
默	mohq
惫	bwwx
舠	dcvd
炜	wwhw
猾	hxqg
煟	wwho
魏	wwhg
氹	dhvu
蹚	thzt
氏	uipv
矢	uipt
祏	uipu
钢	ghjx
襫	uipb
禘	dipj
失	uipf
视	uipe
释	uipl
珅	ufwu
储	iuro
夔	kvbw
呲	cikb
瘕	jxby
潮	icdo
赐	cikw
窥	kvbe
俶	iury
圹	kltg
痂	jxbk
葴	vfck
猕	miqx
氧	yhqy
趯	titf
鳊	bmac
躔	ijzt
舜	uypl
辿	ijze
鳕	xtae
铦	xmjk
哷	lpkc
咧	lpkd
佢	korj
拎	lbfs
铣	xmje
蹼	puzn
锨	xmjr
汭	rvdn
弪	jkgg
馗	kvjz
麖	jkgx
妆	vldn
箴	vfvk
奴	nuny
宰	zdbu
孥	nunz
匦	gvkj
踌	izzc
撙	zyfc
胬	nunr
驽	nunm
努	nunl
夼	kldi
漴	vldx
帑	nunj
灾	zdbh
弩	nung
壮	vldu
嚄	ooky
臭	izzq
状	vldq
坉	tytt
痛	tsby
鲪	jyak
遄	irze
玫	mwww
蠢	iyfi
嘌	pnkx
硍	kfug
瑂	mwwo
停	tkrd
救	jqqw
悢	llxl
典	dmlb
培	pwtk
荪	sycx
贡	gsgr
侹	tkrz
电	dmlv
峰	fgef
柜	jumj
驹	jumk
橘	jumk
枸	jumk
椐	jumk
榉	juml
屄	biub
脐	qiol
氓	mgwm
叵	pokk
拷	kcfv
淑	uudy
区	qukx
哱	pokz
钡	bwjr
逾	yuzd
榍	xpmo
榭	xpmc
觞	uhdp
殇	uhdp
楔	xpmd
壁	biut
辟	biuu
迂	yuzy
奡	aoal
黥	qkhx
绱	uhsk
杉	uamp
革	genl
队	dver
烘	hshb
旞	svfz
艮	gfvn
郐	kkre
跼	jukk
樱	ykmn
楹	ykmm
邰	tdse
哳	vakj
蒴	uoco
蛇	ueib
桯	ykmw
楯	uymo
厍	ueii
狉	piqp
炱	tdsh
台	tdsk
婿	xuno
炝	qlhv
悦	ytxe
絮	xunx
盼	pjod
胖	pjob
栳	lcmb
绳	ugsd
会	kkrs
桉	anmn
铂	bojb
吣	qbkx
钋	pojb
咑	dakd
饸	heuk
嗒	dakk
筀	gvvt
觫	sudu
簋	gvvm
哒	dakz
宿	xqbb
卦	gxtb
旨	vibo
淄	zidt
渍	zidr
拿	naru
槛	kjmm
痔	vibc
恣	zidx
扔	rgfn
阚	kjmw
痓	vibt
粢	zidm
咨	zidk
伐	farg
墐	jbta
宛	yrbv
垡	fart
冤	yrbd
唱	ihko
汶	mfdw
玶	pkwp
獯	xyqh
猡	loqx
呸	pwkp
赔	pwkk
媲	pinb
箬	rovk
鬟	hray
额	eebr
获	hocq
晃	hlow
觳	huuy
縠	huuy
藿	hocf
劐	hocd
痫	xmbm
扉	fwhf
偁	ifrr
痾	eebk
鹕	huun
伧	ifrv
尾	wwum
碨	wwun
螱	wwui
硙	wwuj
乞	qipv
祇	qipu
笮	zovv
尉	wwuc
祈	qipj
慰	wwux
捋	lvfc
旅	lvfn
膂	lvfo
祺	qipb
嘀	dikk
矼	ghug
髃	yugy
浜	bhdb
哋	diky
疑	nibr
肩	jmho
田	tmku
啲	diku
鬻	yugl
侑	yzro
没	mody
佑	yzrk
寝	qbby
鹀	wugn
攸	yzrw
戊	wugp
巫	wugr
漠	modd
庑	wugw
靰	wugw
拇	mufm
沫	modm
优	yzry
悠	yzrx
裙	qypk
逗	dzza
掣	iepu
锛	bfjc
酸	sryw
肿	vsov
漓	lidd
浰	lidd
籣	ljzu
乩	jilv
耤	jilo
曱	gaol
胳	gaok
铖	igji
睿	rvlo
冀	jilb
亟	jila
鹯	vjwn
番	pjpt
襻	pjpu
俨	yjry
翈	xxjx
弇	yjrc
铫	ycjd
偃	yjrn
颤	vjwr
袢	pjpb
钥	ycjo
殳	uujy
谡	suyw
疱	pcbs
鼠	uujv
刨	pcbd
熇	hehk
铫	tnjd
缩	sosb
赗	fgko
酥	suyh
悴	cvxu
褯	jppj
绗	hhsi
豚	tyou
觼	jtdw
暾	tyow
恫	dsxk
镧	ljjj
卲	ucde
尽	jbid
劭	ucdl
潲	ucdo
懂	dsxv
召	ucdk
旧	jqlo
诮	qnyo
乔	qnyl
暂	zjio
谯	qnyh
篷	pgvz
訚	ybmk
蠛	mpiu
芎	xscg
狗	gzqk
苤	ppcp
尸	uivp
筮	uivr
啄	vokn
蝨	uivi
痾	oobk
塘	thtk
忉	dcxd
褚	iupo
柚	yzmy
枱	cimk
初	iupd
说	uvye
剿	jnvd
槱	yzmh
糍	cimy
抄	icfu
纥	gesq
崖	yaet
佶	jirk
茓	xtcb
愆	qmix
堑	qmit
岈	yaey
椠	qmim
忏	ijxq
勔	mmml
苄	bmcb
萹	bmcc
揣	trfe
倜	tirk
潾	lbdl
淋	lbdm
弢	tcgy
抟	trfv
附	fuec
俶	tiry
凛	lbdx
绞	jnsx
捆	kyfm
潵	sjdw
蟒	mhic
厖	mhid
挝	wofz
握	woft
堃	kyft
阱	jkej
竿	gjvg
敢	gjvw
鳤	grak
罟	gusk
瞬	uyol
鳏	grad
袗	vfpp
祯	vfpr
谒	yeyv
莙	jyck
菌	jych
葰	jycw
禛	vfpb
邺	yeye
桧	gvms
闺	gvmt
惆	izxk
氽	tyru
掰	bduu
缮	ujsk
縿	ujsp
棰	ivmi
犬	qrdd
拜	bduf
舛	irxl
朓	tnod
螵	pnix
摩	magu
酶	mwym
麻	magm
蒎	pdcn
淳	iydz
斓	ljwj
美	mwyd
袜	wapm
佃	dmrt
诽	fwyf
椎	ivmf
澄	dgda
潢	gldb
踉	llzl
和	hohk
纠	jqsl
售	uzrk
洸	gldw
	juon
讲	jlyj
叉	iayd
差	iayg
姜	jlyn
瞿	juof
嫦	ihnj
诧	iayq
慷	khxn
蛐	quiq
曩	nhoy
栅	ujmc
蠼	quiy
骐	qimb
脤	ufoy
洘	kcdv
陂	poey
仨	sars
衢	quii
瞫	ufou
焙	bwhk
雕	dnpf
歇	xpor
愉	yuxd
鼾	hjzg
誉	yuxk
胁	xpob
胈	baod
缃	xlso
羽	yuxx
谟	moyd
莎	uacu
逋	buzf
诛	vuyv
偈	jirv
诸	vuyo
锵	qljc
瘊	hzbu
媵	ykon
镪	qlji
锖	qljo
映	ykoy
仲	vsrv
琵	piwb
众	vsrr
黏	nmhk
影	ykop
麝	uegc
琤	igwl
唵	ankd
跃	ytzy
咹	ankn
茺	isce
谲	jtyk
齁	hzzk
诀	jtyn
侬	nsrn
声	ugup
馞	bohz
霄	xnyo
柈	pjmb
攀	pjmu
眚	uguo
甥	ugul
缍	dosi
尥	lnuu
蔟	cucu
捱	aift
纥	hesq
素	sufx
徊	hkik
治	vidk
滞	vidj
滍	vidi
觯	vidl
踪	zszx
㷫	hkuh
瞰	kjow
殖	vidq
沚	vidv
汁	vidu
蚝	hcim
醇	iyyz
楸	qqmh
筋	jbvl
梂	qqmq
毬	qqmq
阊	ihmo
蠔	hciu
购	gzks
珣	xywo
罗	losx
蚜	yaiy
戋	jmad
魉	llgl
络	losk
荬	mdcd
徒	tuir
翡	fwfx
斐	fwfw
徨	hliw
费	fwfr
诓	klyw
衬	ifpc
蜚	fwfi
帻	zejr
蟥	hlib
剕	fwfd
爹	dpbx
滤	lvdx
脏	zhot
耇	gzlk
维	wwsf
灶	zcht
纬	wwsw
屿	yuey
嵎	yuey
泥	nidb
葛	gecv
溺	nidd
揉	rzfm
纲	ghsx
蒻	rocd
锏	jmjo
菹	zucq
嵛	yued
隩	yued
隃	yued
罡	ghsv
祐	yzpk
牖	yzpf
泐	ledl
抹	mofm
釉	yzpy
繇	yzpx
摸	mofd
蜈	wuit
沐	mudm
秘	mihb
芠	wfcw
姘	pbnk
牝	pbnb
嫘	lwnx
姬	jinl
犄	jink
姞	jink
嫉	jinu
砠	juuq
柊	vsmd
妓	jiny
诞	djyz
髁	kegg
命	mkre
翩	pmhx
轧	gaiv
颗	kegr
孺	ruze
殷	yjpy
讹	eeyb
辗	vjin
斩	vjij
榘	juum
匏	pcds
诐	biyy
榛	vfmh
椹	vfmv
胠	quos
桢	vfmr
奅	pcde
堧	rrtd
茳	jlcg
孑	jpva
噤	jbkx
埋	mjtl
松	ssms
烂	ljhs
捎	ucfo
蜕	tvie
淖	iodu
禚	voph
绘	hvss
缋	hvsr
征	vgiv
徵	vgiw
荫	ybco
茵	ybcd
茚	ybce
咱	zjkz
幸	xktg
咩	mpky
鞒	qngl
鞘	qngo
濞	pidl
羓	bayb
硼	pguo
埘	uitc
蹈	dczj
佢	qurj
霸	bayo
道	dczz
恝	jxfx
伉	khrj
铃	lkjs
刍	iude
香	xlho
刳	kudd
尨	phud
味	wwkw
蜂	fgif
恔	jnxx
稌	uuhh
恭	gscx
挟	jxfj
拮	jxfk
共	gscb
觉	jnxe
搿	geuu
怊	icxk
涨	vhdi
澍	vudc
潴	vudo
肷	qmor
芽	yacy
揗	uyfo
注	vudv
洙	vudv
埚	gotn
漳	vhdu
腐	fugr
	tipn
湍	trde
府	fugc
钛	tdjt
鄜	fuge
绷	bgso
裼	tipw
莞	grce
涡	wodn
戌	xuwa
憧	isxl
骺	hzgk
掀	xmfr
掺	xmfp
畜	xuwt
翀	isxv
沃	wody
族	zufu
顼	xuwr
莨	llcl
悃	kyxm
耑	dree
渥	wodt
坍	tjtd
敬	jkcw
辜	guuu
古	guuk
荆	jkcd
坛	tjts
盖	gdym
警	jkck
菁	jkco
眭	gvot
玱	qlwv
侦	vfrr
妯	vzny
觎	yure
骏	jymw
晷	gvok
炅	gvoh
漻	lqdp
褪	typz
板	bjmy
铨	qrjw
拳	qrju
蟫	ybiu
聍	nked
鹤	hedn
券	qrjd
柈	bjmb
瞟	pnox
莘	xbcu
沊	djbu
佤	warw
芯	xbcx
薪	xbcj
受	uzpy
绒	rssu
後	hziw
邹	zzde
志	viux
狙	juqq
弶	jlgx
雎	juqf
具	juqb
犟	jlgn
强	jlgi
器	qikk
㓤	jiud
糁	ufmp
乓	phqd
涐	eedw
嘁	qikx
瞿	quof
朐	quok
啐	qiku
仵	wurw
槟	bbmb
悍	hjxg
鲑	xpat
竑	hsls
憾	hjxx
彬	bbmp
翟	vdxf
氰	qkqo
氢	qkqg
猿	yrqy
威	wwwn
狷	jrqo
蚕	cjti
遮	vezh
甓	piuw
辟	piuu
鼙	piuu
重	vspa
	piun
譬	piuk
嚭	piuk
练	lmsd
劈	piud
刃	rfdd
乘	igqn
珏	jtwy
玨	jtww
越	yttv
崇	isex
弛	iigy
玦	jtwn
魑	iigd
咡	erke
趯	yttf
旭	xujo
鲎	hzxa
菉	lucu
蓼	lucp
觥	gsdw
缈	mnsu
汜	sids
缪	mnsp
狎	xxqj
闿	kdmj
凘	sidj
搔	scfi
死	sidb
芦	luch
泗	side
蕗	luck
揠	yafn
崚	lgew
禾	heqn
饳	doui
缭	lnsx
躲	doum
粗	cumq
嗟	jpkg
贽	vifr
扺	vifu
简	jmvo
执	vifw
昌	ihoo
擿	vifz
恐	ksgx
爪	vcpn
掷	vife
肠	ihop
勘	kjql
摭	vifh
援	yrfy
指	vifo
鸷	vifn
嚆	hckk
斤	jbpl
鉼	bkjk
舰	jmve
笕	jmve
筏	favg
襟	jbpx
囚	qqkr
赇	qqkq
畀	bitl
号	hckv
衿	jbpv
嗥	hcku
钳	qmjg
嗓	shkm
刑	xkkd
邢	xkke
偭	mmrm
校	jnmx
形	xkkp
型	xkkt
腯	tuoo
耋	dplt
萜	tpck
啭	vrkv
姤	gznk
垞	iatt
泷	uldl
髽	vxat
猬	wwqo
媾	gznr
犀	xiun
碏	xiuo
旎	nifb
豨	xiuj
囍	xiuk
熹	xiuh
坚	jmlt
艹	cccc
鉴	jmlj
晪	tmob
屣	xiur
屃	xiur
监	jmlm
饩	xiuq
骶	digd
拟	nifr
傧	bbrb
硒	xiux
憙	xiux
矽	xiux
饻	xiuy
吴	wukt
呜	wukw
褂	gxpb
又	yzvn
揿	qbfr
瓜	gxpn
秦	qbfh
唔	wukk
擒	qbfd
铥	dqjs
炀	yhhp
烊	yhhy
埔	butf
积	jihb
嘎	gakg
乖	gkqb
咖	gakk
稽	jiho
稷	jihw
噶	gakv
竘	kzlk
季	jihz
穄	jihx
媱	ycnf
姚	ycnd
啹	kokk
枲	xism
妖	ycny
狐	huqg
簷	yjvy
沸	fwdf
淝	fwdb
猢	huqo
焉	yjvh
硷	jmua
喤	hlkw
镡	tjju
鄢	yjve
琐	sowr
抛	pcfl
朕	vfot
垅	lstl
昣	vfop
跞	lizl
颃	hhwr
劫	jptl
趌	jptk
珩	hhwi
囤	tykt
腽	waom
逭	hrzk
钝	dyjt
迫	pdzb
斋	vdwe
氡	dsqd
遛	lqzt
犇	bfnn
坼	ieti
魋	tvgf
	ybae
峭	qneo
峤	qnel
逝	uizj
适	uizk
毒	dufm
狈	bwqr
袪	qups
踹	ikze
砟	vauv
凌	lkdw
澪	lkds
邋	lazv
镶	xljy
鲞	xlja
琢	vown
抒	uufl
辞	ciqu
窀	vybt
蕃	fjct
范	fjcv
摅	uufx
甩	ukpv
工	gsaa
扣	kzfk
亚	yaay
瘴	vhbu
牙	yaap
玚	yhwp
倧	zsrx
拄	vufv
冼	xmde
慆	tcxj
媞	tinr
扪	mffm
儿	erpv
鳆	fuaw
鞭	bmgg
埔	putf
夫	fuan
傕	qtrf
莿	cicd
鲋	fuac
甫	fuad
媂	tinj
涎	xmdz
鬣	lpav
棺	grmk
赛	sdbr
濂	lmdn
枘	rvmn
抠	kzfx
喽	lzkn
窝	wobn
顶	dkdr
鲸	jkax
哝	nskn
井	jkal
牠	tany
鼫	uiju
滆	gedl
锐	rvje
鲑	gvat
缹	bcfh
鳜	gvar
昄	bjoy
晙	jyow
骂	makm
嘛	makm
朴	pnmb
盗	dcdm
膻	ujod
寂	jiby
恸	tsxl
咛	nkkd
骠	pnmx
睒	ujoh
劏	tsxd
娆	rcnw
囧	jskv
狨	rsqu
簟	dmvu
臜	zaor
灯	dghd
讬	iaut
馇	iaud
铛	dhje
囔	nhky
貆	hrvg
驱	qumx
镍	npjm
阒	qumq
莘	ufcu
葚	ufcv
薢	xpcn
薤	xpcj
镊	npjy
蜞	qiib
麴	qumm
背	bwlo
㶶	nshy
北	bwlb
邶	bwle
蛴	qiil
撖	hjfw
撼	hjfx
膑	bbob
扞	hjfg
惛	hyxo
茼	tsck
午	wupg
乌	wupa
舞	wupl
烚	xxhk
蔸	dzce
釐	xiwl
锆	gcjk
亥	hdwr
抢	qlfv
盅	vsvm
砄	jtun
忠	vsvx
忸	nqxi
浙	vedj
虚	xuhy
痈	ysby
卜	bold
耻	iiev
撕	sifj
堡	burt
蟠	pjit
鲈	luau
唠	lckl
溞	scdi
饨	tyut
鲁	luao
塑	subt
窣	subu
爆	bchu
峛	lied
亸	dowu
佴	erre
獠	lnqx
宿	subb
癌	aibe
兹	ziby
皑	aibj
孳	zibz
沓	dauo
槐	hkmg
蜐	jpil
鲳	ihao
街	jpii
渊	yrdl
秩	vihu
沅	yrde
笊	vcvv
稙	vihq
湲	yrdy
源	yrdx
稚	vihf
崆	kseg
厂	ihap
鲿	ihas
蠃	lowf
炳	bkhb
珞	lowk
啪	pakb
仅	jbry
蝤	qqiy
金	jbra
蚯	qqiq
虬	qqiv
绢	jrso
碗	wjuv
毁	hvjy
杏	xkmk
烠	hvho
哣	pzka
玩	wjwe
骍	xkmu
鼢	ffjd
奸	jmng
帟	yiwj
竖	uull
犍	jmnz
憎	zgxo
藤	tgcu
溱	qbdh
鲮	lkaw
梢	scmo
炸	vahv
怩	nixb
曹	ccao
沁	qbdx
阗	tmmb
片	pmpv
杌	wumw
蜍	iuih
滫	xqdo
厨	iuic
梧	wumk
癗	lwbt
啵	boky
迓	yazy
芈	mill
飏	yhjp
脯	puof
曝	puou
苛	keck
蛞	koik
虸	ziiz
辒	wfim
盐	yjtm
堰	yjtn
眼	yjog
打	dafd
埏	yjtz
痱	fwbf
梌	tumh
毡	vjmk
栈	vjmj
隍	hlew
蠖	hoiy
栴	vjmd
谋	mzym
萘	ndcx
笼	lsvl
慄	lixm
悝	lixl
轸	vfip
莱	ldcl
勺	ucbd
炖	dyht
遗	yizr
迆	yizy
览	ljle
逸	yizd
劓	yizd
蛙	wait
幢	iljl
梼	dcmc
汾	ffdd
皴	cysy
庭	tkgz
灸	jqjh
珲	hvwi
舅	jqjl
鸠	jqjn
谩	mjyy
荞	qncl
姹	ianq
峥	vgel
引	ybgl
刀	dcvp
恃	uixc
傥	thre
渎	dudd
琲	bwwf
渡	dudy
龋	quvy
岜	baeb
备	bwwt
铗	jxjj
郏	jxje
荤	hyci
象	xldn
湘	xldo
垒	lwst
斫	vouj
镓	jxju
颊	jxjr
淳	vydz
嬖	biun
臂	biuo
刹	uaxd
澍	uudc
踎	bwkk
攻	gsgw
汞	gsgu
盖	geym
哥	gedk
襞	biuy
悯	mbxw
功	gsgl
漱	uudr
索	soux
殊	uudv
巩	gsgf
贲	biur
沭	uudu
茀	fucf
釜	fuba
艋	mgvm
芣	fucb
苻	fucc
姆	munm
芾	fucl
茯	fucq
骖	cjmp
冁	ijbn
璠	fjwt
莩	fucz
菔	fucy
骠	bnmx
宪	xmbe
堡	purt
懑	mfdx
杓	bnmu
仆	purb
琫	bgwl
逃	tczd
骉	bnmm
蝙	bmic
镞	zuju
矞	xusk
酤	guyk
绪	xuso
续	xusd
戏	xiyg
蝼	lzin
姥	munb
羖	guyy
惔	tjxh
牲	ugnu
赣	gjlr
覃	tjxu
朵	dojm
铎	dojl
宙	vzby
剁	dojd
苎	vuca
婘	qrnv
著	vuco
通	tszy
闪	ujmr
杉	ujmp
骟	ujmx
蟆	maid
偶	oury
薸	pncx
蚂	maim
镫	dgja
坫	dmtk
蒨	qmco
颋	tkzr
荨	qmcc
爇	roch
茜	qmcx
铿	kgjt
鄀	roce
芡	qmcr
芊	qmcq
垩	eeyt
恶	eeyx
坩	gjtg
矩	juuj
局	juuk
浭	ggdg
屦	juun
蒋	jlcc
詻	eeyk
剧	juud
垸	hrte
僎	vrrb
赚	vrrk
鲹	ufap
穜	tshl
捶	ivfi
传	vrrv
磅	phuf
犒	kcnk
枇	pimb
靠	kcnf
麒	qigb
伛	yurx
悆	yurx
俣	yurt
畬	yurt
瀚	hjdx
余	yurh
汗	hjdg
俞	yurd
浛	hjdk
磬	qkuu
匼	qxkk
攘	rhfy
侮	wurm
罄	qkuf
碃	qkuo
玭	pbwb
酹	lwyc
诔	lwyl
瑓	lmwj
豆	dzaa
雷	lwyt
稿	gchk
稔	rfhx
恋	lmwx
氦	hdqr
琏	lmwz
绝	jtsb
澭	ysdf
乐	ytpd
矞	jtsk
永	ysdn
晢	vefo
蜇	vefi
粤	ytpv
哲	vefk
折	vefj
泳	ysdy
硬	ykug
摺	vefb
帛	bobj
瘪	bpbb
瘙	scbi
茌	iicu
埗	butp
埠	butu
私	sihs
硖	xxuj
萧	xncs
庐	lugh
矞	yusk
鹿	lugb
蜜	mibi
徂	cuiq
荔	licl
莅	licl
苈	licl
帜	vijb
抱	bcfs
暸	lnox
帙	viju
铚	vijt
耔	zilz
锧	vijr
赵	vctx
藜	licu
菖	ihco
蒽	encx
砍	kjur
远	yrze
磡	kjul
睫	jpor
苌	ihcv
嬲	nntl
垴	nctk
廙	yigb
球	qqwq
璆	qqwp
昊	hcot
颢	hcor
霾	mdyl
弯	wjwg
讯	xyyu
烩	hvhs
醺	xyyh
训	xyyi
询	xyyo
釭	ghjg
秽	hvhx
琬	wjwv
娩	mmnv
腥	xkou
垍	jitz
漫	mjdy
钩	gzjs
箐	qkvo
荻	dich
蒂	dicj
瀵	ffdb
	vrov
觏	gzje
菂	dicu
奋	ffdt
	xiyj
邝	klge
醯	xiym
铡	vajd
逆	nizp
羲	xiyd
锓	qbjy
牡	munt
牧	munw
钦	qbjr
臭	xqzq
旿	wuow
萏	djcj
晤	wuok
央	yhln
漯	lwdx
抡	lyfb
幂	mibj
棹	vomu
泪	lwdo
宓	mibb
朴	pumb
入	rupn
襦	rupe
褥	rupc
氆	pumo
䢛	jszk
乳	rupv
趌	jitk
圾	jitj
嘿	hwkh
愃	xrxg
愠	yyxm
窅	ycbo
窈	ycbl
恽	yyxi
瞻	vjok
疟	ycba
窑	ycbf
吻	wfkw
延	yjzv
名	mkxk
惛	mfxo
砣	toub
荼	tuch
菟	tucd
迳	jkzg
炔	qthn
讬	tout
叟	szpy
嚄	hoky
棁	vome
葖	tucq
均	jytd
䟴	vfky
钣	bjjy
鋆	jytj
畯	jyty
赈	vfkn
韶	uclk
揼	dyfu
哇	wakt
乂	yixx
忆	yixv
髯	rjar
箄	pdvu
怿	yixl
衅	xbxb
怡	yixk
刈	yixd
翼	yixb
悒	yixb
羿	yixc
呙	wakn
鎔	rsjk
莝	coct
酒	jqdy
杙	yimy
灰	hvuh
剒	cocd
氿	jqdj
卉	hvuc
说	ytye
隐	ybex
阴	ybeo
崟	ybej
碑	bwuu
坥	qutq
孛	bwuz
趣	quty
祷	dcpc
趋	qute
魃	bagd
臂	bwuo
姮	hgng
鐾	bwuj
碚	bwuk
耥	thlk
弔	dngl
芩	qbcv
缴	vosw
窟	kubi
稼	jxhu
磁	ciuy
珢	kfwg
妭	band
珌	biwb
葑	fgcc
帅	uklj
碧	biwu
疰	vubv
噱	xtku
阌	wfmy
榑	fumc
甏	bguw
泵	bguu
桴	fumz
脿	bnoy
膘	bnox
瘃	vubn
锑	tijp
临	lbll
匾	bmkc
贬	bmkf
荄	gdcr
溚	tadk
	lzon
鲘	hzak
桡	rcmw
脓	nson
蒸	vgch
乐	lcpd
铊	tajb
埆	qtty
甘	gjna
翘	qnax
垌	tstk
簇	cuvu
膙	jloi
川	irpl
赡	ujkk
籀	vzvt
馧	wohm
踮	dmzk
侴	hcrd
榫	symu
悰	csxx
咋	zakv
倞	llrx
崃	ldel
咱	zakz
疟	ntba
俍	llrl
咂	zakj
亓	qiel
碟	dpum
崎	qiek
屺	qiej
鹅	eewn
噩	eewk
璪	zcwm
岐	qiey
猹	iaqd
挡	dhfe
窄	vdbv
宅	vdbq
廨	xpgn
捏	npft
瘵	vdbx
寨	vdbm
鞋	xpgt
谛	diyj
毓	yupv
裕	yupk
臾	yupn
舆	yupb
寒	hjbd
嗷	aokw
罕	hjbg
僮	vlrl
圬	wutk
刿	gved
瀼	rhdy
州	vzdl
勍	qkwl
洲	vzdv
皱	vzdy
揍	zzft
坞	wutw
磏	lmun
嬴	ykwf
崀	lhel
璎	ykwn
唉	aiku
瑛	ykwy
踵	vszv
龠	ytrc
玃	jtqy
拥	ysfy
豉	iiay
獗	jtqr
嗌	aikm
葜	qxcd
簿	buvc
陆	luej
飔	sijx
步	buvp
淼	mnuu
鳉	jlac
增	zgto
豇	jlag
瑕	xxwy
琚	juwk
珇	juwq
止	vila
姊	zinp
郦	vile
狍	pcqs
丽	liad
鳢	liaa
吏	lian
鲡	lial
怨	yrxx
朊	rroe
忻	xbxj
蛏	igit
砮	nunu
眢	yrxo
楷	jpmb
杰	jpmh
桔	jpmk
檞	jpmn
铙	ncjw
峄	yiel
鲆	pkap
屹	yieq
嶷	yier
匮	gvkr
郜	gcne
告	gcnk
采	cdpm
彩	cdpp
愔	ybxo
汽	qidq
汔	qidq
夤	ybxb
酞	tdyt
歅	ybxr
莳	uicc
蹇	jmbr
猰	qpqd
傍	bhrf
沟	gzds
翦	jmbx
剪	jmbd
骥	jimb
髢	diay
鹣	jmbn
煎	jmbh
謇	jmbk
酉	yzxa
絜	xpfx
鹚	cibn
辖	xxik
狯	kkqs
忧	yzxy
楚	iumr
杵	iumw
樗	iumv
瀑	bcdu
橱	iumc
柷	iume
沏	qidd
楮	iumo
玹	xmwy
血	xtpm
近	jbzj
擂	lwft
卵	lrpd
耒	lwfn
慈	cibx
沦	lydb
噗	pukn
徭	ycif
己	jivv
圃	pukf
儒	rure
谮	zfyo
籍	jivo
戛	gaag
笄	jivk
笈	jivj
箕	jivb
躐	lpzv
段	drpy
恹	yjxq
榅	wfmm
篌	hzvu
叁	sjss
参	sjsp
鳣	vjad
闻	wfme
恧	nvex
纭	yyss
组	zusq
毵	sjsm
色	uddb
栝	komk
娜	none
鳇	hlaw
憬	jkxx
沓	tauo
菼	tjch
尘	ifxt
忱	ifxv
筠	jyvd
捭	bdfu
阵	vfei
摆	bdfs
沌	dydt
侗	dsrk
崧	sses
祃	mapm
苒	rjcr
牌	pdpu
嵩	ssek
缵	zrsr
韭	jqfa
揪	jqfh
卍	wjvv
莛	tkcz
遣	qmzk
葶	tkcd
迁	qmzq
熔	rshk
塽	ultx
坋	bftd
锸	iajj
镲	iajx
靶	bagb
祋	dvpy
耪	phlf
帑	thnj
垃	latl
鲃	baab
掹	mgfm
笳	jxvk
倒	dcrd
玼	ciwb
嫁	jxnu
咲	grkt
篑	kvvr
戣	kvvg
勃	bwul
腘	gooy
铘	yeje
羧	soyw
狴	biqt
栽	zdum
瑢	rswk
载	zdui
哉	zduk
催	cvrf
丰	fgal
镆	mojd
翥	vulx
腑	fuoc
掺	ijfp
脯	fuof
煮	vulh
腹	fuow
搀	ijfd
裈	kypi
疲	piby
痺	pibu
莽	mhcc
娄	lzmn
否	pibk
痞	pibk
祲	kypy
芒	mhcw
羌	qlyv
丐	gdav
疔	dkbd
睺	hzou
怦	pgxp
瞧	qnoh
搒	bhff
佬	lcrb
秆	gjhg
礤	caux
佺	qrrw
柠	nkmd
蟮	ujik
筒	tsvk
鬯	ihxb
船	irvk
氅	ihxm
惝	ihxk
常	ihxj
怅	ihxi
抖	dzfu
敞	ihxw
尝	ihxs
裳	ihxy
衃	pwxb
弱	rogd
墚	lltm
郝	hcte
殆	dddk
惦	dmxk
锥	vvjf
涓	jrdo
萁	qicb
馕	nhuy
葺	qice
芑	qicj
屾	ufee
坊	fhtf
萋	qicn
荠	qicl
铐	kcjv
册	cepa
座	zogt
谫	jmyd
篆	vrvu
艅	yuvh
龉	yuvk
聿	yuvl
谏	jmyj
邪	xpye
谢	xpyc
谐	xpyb
竽	yuvy
郤	xibe
畋	tmtw
忝	tmtx
兮	xibv
矜	qbsv
填	tmtb
虢	gopj
怼	dvyx
窸	xibx
叚	jxvy
廆	gvgg
毋	wuva
夜	yewn
陡	dzer
忌	jijx
廊	lhge
螓	qbih
矣	yisu
忪	vsxs
觉	jtxe
甴	zaol
滃	wgdx
蠕	ruie
眙	iiok
辱	ruic
氨	anqn
诚	igyi
匙	iiob
矍	jtoy
酲	igyw
胣	iioy
眵	iiox
慵	ysxl
喵	mnkt
芫	yjce
噜	luko
播	boft
绎	yisl
搏	bofc
拨	bofd
耜	silk
椪	pgmy
勉	mmdl
霞	xxyy
屙	eeuk
护	hufh
饿	eeuw
魈	xngo
醵	juyu
螋	sziy
嘹	lnkx
脷	liod
姪	vint
慬	jbxa
藉	jpco
胤	ybpv
节	jpce
苹	pkcp
荑	yicy
薏	yicx
苡	yicr
遹	yuzk
粃	pamb
镘	mjjy
纨	wjsw
退	tvzg
绾	wjsk
谓	wwyo
诿	wwyn
霨	wwyc
拘	gzfk
荥	xkcu
荇	xkci
铝	lvjk
十	uial
歼	jmdq
豕	uian
	uian
鲺	uiai
石	uiak
腊	laoo
钔	mfjm
旯	laoj
湔	jmdd
减	jmdk
溅	jmdj
世	uiav
涧	jmdo
酷	kuyk
脍	kkos
券	xrjd
隗	kveg
勤	qbnl
诃	heyk
刨	bcbd
嫑	bcbn
包	bcbs
演	yjdb
滟	yjdb
沇	yjde
宝	bcby
垭	yaty
堐	yatt
镟	xrjr
吝	lbwk
系	jipx
琳	lbwm
璘	lbwl
袅	nnpy
簖	drvj
几	jipv
及	jipn
弹	djgl
涢	yydr
沄	yyds
管	grvk
筦	grve
痼	gubk
毌	grva
趔	lptd
榰	vimo
课	keyg
蘸	vjch
贯	grvr
抻	iffu
愣	lgxf
颈	jkvr
荒	hlcv
箐	jkvo
醐	huyo
劲	jkvl
鄠	huye
烶	tkhz
橦	tsml
桐	tsmk
桶	tsmy
菘	sscs
鸥	oukn
揽	ljfe
剽	pnxd
烧	uchw
俳	pdrf
桌	volm
徕	ldil
殴	ouky
呕	oukx
昈	huoh
瓯	oukw
稍	ucho
甙	ddyg
笨	bfvb
屮	iell
诒	ddyk
梃	tkmz
搣	mifh
桯	tkmw
慊	qmxn
悭	qmxt
槭	semx
茇	bacd
芭	bacb
跂	qizy
胸	xsok
卅	saal
词	ciyk
敫	jnbw
蚣	gsis
袈	jxly
差	ciyg
皎	jnbx
魂	hyeg
甲	jxll
驾	jxlm
加	jxlk
椁	gomz
窖	jnbk
耐	ndec
傻	uarw
焆	yeho
烨	yehu
耏	ndep
纰	bisb
替	tifo
蝠	fuit
壬	rfqa
蝮	fuiw
蜉	fuiz
桑	shym
蔈	bncx
爨	crph
汰	tddt
擿	tifz
辅	fuif
蚨	fuif
嬛	qsny
提	tifr
蒌	lzcn
踒	wozn
糇	hzmu
饺	jnux
凿	zcyk
枞	csmr
渑	ugdd
斯	siqj
榷	qtmf
呒	omkw
樵	qnmh
桥	qnml
橇	qnmm
歜	iusr
讷	neyn
霭	aiyv
斑	bjww
仟	qmrq
谖	xryy
相	xlmo
拆	cafi
酝	yyys
堾	irto
嵋	mweo
钬	hojh
狲	syqx
御	yuie
带	ddfj
伣	qmre
貉	hcvk
毚	ijdd
婠	wjnk
阡	qmeq
嵌	qmer
捐	jrfo
岍	qmek
缞	cvsy
婉	wjnv
岞	zoev
鳍	qiao
妻	qian
鲯	qiab
郪	qiae
率	lvwu
仿	fhrf
烤	kchv
七	qiav
堉	yuto
擿	vdfz
滂	phdf
髌	bbgb
域	yuta
摘	vdfk
保	bcrm
圫	yutq
馍	moud
璈	aoww
亩	muwt
憝	dvwx
敦	dvww
诡	gvyv
怃	wuxw
蚆	baib
	vzxe
奘	vlvd
悟	wuxk
射	yeuc
詟	velk
鹟	wgbn
唞	dzku
妊	rfnr
啴	toku
蠊	lmin
哣	dzka
瓮	wgbw
桷	jtmy
嚅	ruke
踊	yszy
驰	iimy
橛	jtmr
尜	gaxx
柢	iimd
钹	bojd
镈	bojc
辂	luik
浡	bodz
蹩	bpdr
辘	luib
姒	sinr
憋	bpdx
渤	bodl
鳖	bpda
鲬	ysay
泊	bodb
髂	qxgk
轳	luiu
侧	cerd
滹	hudh
冱	hudh
瓠	hudg
隺	hudf
嬛	hrny
途	tuzh
嗽	szkr
濩	hudy
淴	hudx
嗾	szku
户	hudu
斛	hudu
浒	hudw
嗖	szky
糨	jlmi
慌	hlxv
恍	hlxw
李	limz
卮	vipv
质	vipr
禔	vipr
豸	vipp
锱	zijt
鲒	jpak
制	vipd
祗	vipd
骊	liml
枥	liml
栎	liml
朸	liml
欐	limb
牦	mcnm
颟	mjcr
炙	viph
邱	qqqe
犰	qqqj
秉	bkpn
裘	qqqy
蕈	xycu
溯	sudo
弋	yiad
荨	xycc
荀	xyco
薰	xych
鹝	yian
鲽	dpam
虑	lvhx
滑	hxdg
廆	wwgg
稆	lvhk
觟	hxdt
坬	gxtg
室	uibt
忿	ffbx
叨	dckd
搛	jmfn
捡	jmfa
拣	jmfd
供	gsrb
	jkfn
猰	jxqd
滓	zidu
穆	muhp
垓	gdtr
鞨	hegv
夙	sujd
闽	mbmi
逢	fgzf
妣	binb
砲	pcus
闵	mbmw
婢	binu
愍	mbmx
迩	erzx
赴	futb
璋	vhwu
伋	jirj
集	jirm
崒	zueu
聃	djer
滋	zidy
耽	djev
伎	jiry
抵	difd
噏	hakx
垺	futz
澡	zcdm
层	cgus
洼	wadt
塅	drty
磷	lbul
痣	vibx
境	jkte
沽	gudk
嵁	vjev
盥	grpm
汩	gudo
伭	xrry
祼	grpg
觚	gudg
鳁	wfam
姿	zidn
洓	zidn
嶦	vjek
崭	vjej
匀	yybd
郓	yybe
艘	szvy
獭	taqr
弹	tjgl
蓝	ljcm
箦	zevr
鼍	tokd
沉	ifdj
唾	toki
俊	jyrw
曈	tsol
屯	tyav
鲀	tyat
隽	jyrn
漤	ljdn
滥	ljdm
澜	ljdj
鹠	lqpn
信	xbrk
伈	xbrx
留	lqpt
疚	jqbj
创	ilrd
嵯	coeg
溶	rsdk
咣	glkw
汨	mido
洣	midm
羊	yhbl
泌	midb
貌	mcve
疡	yhbp
伢	yary
痒	yhby
昉	fhof
镋	thje
氕	ppqp
朳	bamb
粃	bamb
搽	iafm
镗	thjt
插	iafj
傀	kvrg
幪	mgju
锰	mgjm
肱	gsos
角	jndy
呙	gokn
婻	njng
漖	jndw
湫	jndh
国	goky
戈	gead
鲷	dnak
超	ictk
妠	njnr
鬒	vfab
瞅	izoh
华	hxru
敏	mbpw
鳘	mbpa
批	pifb
汋	qtdu
涕	tidp
赋	fukv
呒	fukw
蹰	iuzc
擗	pifu
铋	bijb
咈	fukf
披	pify
泰	tdfu
咐	fukc
赙	fukc
纴	rfsr
跹	xmzz
碥	bmuc
坤	kytu
埫	istk
蚩	iivi
篪	iivj
笞	iivk
剅	lzad
陔	gder
吼	hzkv
喉	hzku
矼	qlug
暹	xmzf
跣	xmze
淦	gjdj
拢	lsfl
泔	gjdg
耏	erep
缌	sisx
澉	gjdw
梨	lihm
寮	lnbx
笱	gzvk
陕	ujej
吐	tukt
箜	ksvg
忑	texx
瑷	aiwy
糜	mwgm
侗	tsrk
僮	tsrl
狞	nkqd
蘼	micf
柁	domb
佟	tsrd
仝	tsrg
褕	yupd
钏	irji
筢	pavb
舥	pavb
丛	csra
瘰	lobx
淠	pwdl
舯	vsvv
铲	ijji
疗	lnbl
烛	vuhi
刬	ijjd
烷	wjhe
揣	vvfe
炷	vuhv
赘	vvfr
镡	ijju
屡	lvun
谌	ufyv
绖	dpst
唑	zokt
谂	ufyx
诜	ufye
履	lvuw
咗	zokg
钪	khjj
偁	igrr
鬓	bbab
鲩	hrae
钰	yujy
恬	tmxk
胡	huuo
肏	ccrr
舁	yujc
扱	xifj
木	muun
嶲	gvev
碓	dvuf
琴	qbwv
迕	wuzw
嶝	dgea
臁	lmon
脸	lmoa
莨	lhcl
蓢	lhco
吃	iikq
噘	jtkr
噱	jtku
叱	iikb
炅	jsoh
喫	iikd
嚼	jtkc
褽	wwuy
嗤	iiki
呎	iiki
暅	xrog
晅	xrog
鸮	xnkn
嚣	xnkk
睩	luou
邅	vjzd
瞄	mnot
眇	mnou
蓂	mkcb
哮	xnkz
哓	xnkw
茗	mkck
甦	sugu
眩	xroy
昡	xroy
卜	buld
耕	gglj
遑	hlzw
祁	qipe
匠	jlkj
戒	jpgc
侄	virt
值	virq
骱	jpgl
黔	qmhv
玿	ucwk
涔	cfdv
浸	jbdy
浕	jbdd
殣	jbdf
觔	jbdl
阮	rree
溍	jbdo
胰	yioy
臆	yiox
易	yiow
昳	yiou
鲟	xyac
眙	yiok
媆	nfnd
碈	mbuo
睾	gcpu
龂	kfvj
醢	hdym
蚪	dziu
菽	uucy
踩	cdzm
砉	hxfu
阢	wwew
峗	wwev
雊	gzbf
够	gzbx
崴	wwen
隈	wwen
勾	gzbs
啦	lakl
示	uiex
岗	ghex
喇	lakd
倪	nire
峙	uiec
痄	vabv
伲	nirb
塝	bhtf
珈	jxwk
鸺	xqrn
休	xqrm
猷	yzbq
哙	kkks
矻	kuuv
眶	klow
疣	yzby
蝻	njig
宥	yzbo
旷	klog
调	tnyk
唎	likd
陇	lsel
秕	bihb
馝	bihb
呖	likl
喱	likl
唳	likq
嚟	liku
髎	lngp
簠	fuvm
弗	fuvl
嗯	enkx
垏	lvty
赕	djkh
蛤	haik
符	fuvc
噉	djkw
甭	bgby
绨	tisp
磕	keum
壳	keuj
廓	koge
克	keue
锻	drjy
斡	wouu
硪	wouw
皂	zcbq
禤	xrpx
悱	fwxf
螨	mjil
儆	jkrw
碇	dkur
倌	grrk
倞	jkrx
罉	chfu
苹	pgcp
蓬	pgcz
芃	pgcf
柝	tomi
疢	ifbh
宸	ifbn
椭	tomo
炭	tjeh
柁	tomb
驮	tomd
巷	hhcs
梾	ldml
蚺	rjir
孖	mazz
烔	dshk
鸸	eren
囟	xbpx
𨅬	ljzj
啋	cokm
店	dmgk
厅	tkid
冗	rsbj
蜓	tkiz
贸	mcpr
卯	mcpe
迷	mizm
漾	yhdy
殃	yhdy
泱	yhdy
渖	ufdu
骰	tzgy
烫	thdh
溏	thdk
枋	fhmf
笸	povk
汊	iadi
颇	povr
汤	thdp
挢	jnfl
搅	jnfj
桹	lhml
蝈	goiy
慨	kdxv
勦	icvl
蜾	goig
巢	icvg
剿	icvd
蓁	vfch
眸	mzon
椆	izmk
曳	yelp
杻	izmi
顷	qkbr
梼	izmc
焠	cvhu
诹	zzyy
业	yela
扁	pmhc
彖	trvu
磔	veum
咸	xmxk
瘿	ykbn
喆	veuk
颍	ykbr
弁	bmsc
茝	idcl
缺	qtfn
缏	bmsg
剃	tibd
饪	rfur
澼	pidu
鹈	tibn
橑	lnmx
谞	xuyo
艟	isvl
酗	xuyk
坻	iitd
虫	isvd
需	xuye
墀	iitn
厚	hziz
诩	xuyx
訏	xuyy
髅	lzgn
赅	gdkr
饲	siuk
擀	gjfg
僇	lurp
姱	kxnk
搋	ikfj
缁	zist
埪	kstg
芟	ujcy
删	ujcd
苫	ujck
洛	lodk
裴	pwfy
泺	lodl
囱	cspw
垙	gltw
旆	pwfl
漯	lodx
仂	lerl
铸	vujc
铢	vujv
缕	lvsn
呯	pkkp
炕	khhj
绿	lvsu
铛	igje
虞	yuht
锲	qpjd
蚄	bhif
酚	ffyd
鸳	yrxn
燠	yuhd
燏	yuhk
煜	yuhl
症	vgbv
璮	tjwd
牟	musn
襚	svpu
玺	xidy
汐	xidx
裇	svpx
洗	xide
溪	xidd
潟	xidh
觿	xidk
浠	xidj
夺	dodc
绊	bjsb
碍	aiuc
踝	hkzg
矮	aiun
搭	dafk
畎	qrtq
毐	aiuw
滇	dmdb
沲	dody
胍	gxog
砹	aiux
缧	lwsx
劂	jtid
钥	ytjo
厥	jtir
钺	ytjv
冢	vsbn
榔	lhme
梌	iamh
庱	iggw
杪	mnmu
㞹	keek
螭	iiid
妪	yunx
岩	yjeu
蟏	xnis
楦	xrmg
栌	lumu
氇	lumo
崦	yjed
儳	ijrd
蛸	xnio
麓	lumb
糸	miyx
镮	hrjy
豢	hrju
瞍	szoy
腭	eeok
阶	jpel
埴	vitq
爰	yrpy
址	vitv
欸	eisr
畤	vitc
蝥	mcsi
悚	ssxu
忪	ssxs
驿	yiml
椅	yimk
枍	yimv
孬	ncbz
蚲	pkip
栘	yimx
彗	hvfe
挥	hvfi
曰	ytka
慧	hvfx
脰	dzoa
楙	mcmm
楝	lmmj
栐	ysmy
筶	gcvk
唪	fgkl
梿	lmmz
懋	mcmx
薳	wwcz
羝	diyd
苇	wwcw
萎	wwcn
葳	wwcn
蔚	wwcc
计	jiyu
擢	voff
溠	vadg
嘘	uiky
渣	vadd
滕	tgou
噬	uikr
拙	vofi
嗜	uiko
啫	uiko
坭	nitb
蝲	laid
捉	vofr
螣	tgoi
蜡	laio
奓	vadx
芏	duct
	tgoa
疵	cibb
除	iueh
嘲	icko
颉	jxur
姈	lkns
亍	iuel
袖	xqpy
框	klmw
捌	bafd
吵	icku
嘉	jxuk
兹	ciby
弓	gsvv
簌	suvr
励	liil
厘	liil
轹	liil
挲	sodu
琡	uuwy
孰	uuww
糖	thmk
蜊	liid
塾	uuwt
溹	sodx
苓	lkcs
聊	lnee
菏	heck
熟	uuwh
娑	sodn
厉	liiw
蛎	liiw
戍	uuwd
肃	suvl
凫	fupj
蒲	pucf
莆	pucf
蒱	pucf
霖	lbym
菩	puck
郛	fupe
祓	fupd
孚	fupz
袱	fupq
复	fupw
阜	fupu
福	fupt
哷	lvkc
颏	kewr
煅	drhy
刻	kewd
魍	whgw
孕	yynz
覅	mqxw
珂	kewk
妘	yyns
脱	tooe
玎	dkwd
沧	chdv
篚	fwvf
飞	fwvd
雇	guhf
印	ybpe
醒	xkyu
迮	zezv
晕	yyoi
叹	tjky
湎	mmdm
啴	tjku
渑	mmdd
禋	ybpt
棚	pgmo
挪	nofe
搦	nofd
沔	mmdv
睐	ldol
痕	hfbg
嗵	tskz
档	dhme
哃	tskk
懒	ljxr
欸	aisr
巅	dmer
扯	iefv
撤	iefw
骢	csmx
厝	coio
阽	dmek
胱	glow
削	xtxd
峃	xtxe
祎	yipw
缠	ijsl
痲	mabm
娅	yany
蓍	uico
倩	qmro
泶	xtxu
硁	kgug
敩	xtxw
扬	yhfp
佥	qmra
姶	yank
搪	thfk
靸	sagj
鄱	pope
牍	dupd
癯	qubf
劬	qubl
鸲	qubn
繁	popx
蓓	bwck
燋	jnhh
叕	voyy
酌	voyu
琀	hjwk
椆	dnmk
诼	voyn
飨	xlxl
嵴	jieo
睢	svof
咔	kakb
熵	uhhk
喀	kakk
咯	kakk
咭	kakk
清	qkdo
亟	qila
眭	svot
隔	geel
犯	fjqv
摔	ukfu
爷	yebe
绸	izsk
篡	crvs
韧	rfwr
溁	ykdm
筅	xmve
瀛	ykdf
潆	ykdx
滢	ykdy
疃	trtl
舷	xmvy
跆	tdzk
鲂	fhaf
砭	bmuf
魆	xugv
佁	iirk
揞	anfo
按	anfn
陋	lzev
傺	iirx
嵝	lzen
序	xugl
铤	dkjz
荛	rccw
诤	vgyl
锭	dkjr
证	vgyv
禄	lupu
驲	rimo
翛	xnrx
钉	dkjd
窭	jubn
岔	iabe
句	jubk
僵	jlra
韂	ijgk
察	iabx
疽	jubq
园	yrke
錾	zjij
冚	kjbe
骃	ybmd
倥	ksrg
兆	vced
呐	nakn
鳝	ujak
圆	yrkr
踭	vgkl
鳣	ujad
圜	yrky
哪	nake
簦	dgva
凳	dgvj
摞	lofx
饶	rcuw
捋	lofc
趴	pazb
菜	cdcm
涴	wjdv
蔡	cdcx
鲧	gyax
湾	wjdg
汍	wjdd
婵	ijnl
獬	xpqn
氯	lvqu
锤	ivji
呢	nikb
妾	qpln
匿	nikk
娱	yunt
膀	bhof
妤	yunl
焓	hjhk
焊	hjhg
僔	zyrc
锡	xijw
咻	xqkm
嗅	xqkq
舄	xijh
圙	ltkm
铣	xije
鼷	xijd
溚	dadk
耷	dade
掇	dofy
栝	gxmk
踡	qrzv
觊	jiee
冏	jskk
瀹	ytdc
岌	jiej
儋	djrk
锗	vejo
猺	ycqf
际	jiex
鹋	mncn
暝	mkob
菸	yjcd
藐	mnce
谙	anyo
苗	mnct
焕	hrhd
晓	xnow
觃	yjkz
咺	xrkg
匽	yjkn
菥	xicj
啱	yjkk
咽	yjkd
郾	yjke
睄	xnoo
鹱	huny
艎	hlvw
鹄	hunn
恻	cexd
胙	zoov
嫭	hunh
簧	hlvb
阏	eemd
党	dhxe
箢	yrvv
锎	kdjk
铠	kdjj
贻	yikk
峋	xyeo
敦	dyww
趸	dywr
颐	yikr
卖	mdud
呓	yikv
医	yiku
姱	hunk
绍	ucsk
翳	yikx
繄	yikx
洄	hvdk
悼	dcxu
浍	hvds
眊	mcom
冒	mcoo
扭	nqfi
攰	lwul
拗	nqfl
昕	xboj
礌	lwut
磊	lwuu
莲	lmcz
氿	gvdj
蔹	lmcw
枓	dzmu
嘟	duke
轼	uiig
鱽	dcad
帝	diwj
赌	duko
铧	hxju
凶	xsxk
坝	batr
玓	diwu
锃	zgjw
岿	kvee
涿	vodn
浊	vodi
贶	klke
濯	vodf
劻	klkl
揸	vafd
鞡	lagl
聩	kver
哐	klkw
汋	vodu
拃	vafv
搾	vafv
终	vssd
槱	icmh
石	djak
封	fgtc
泚	cidb
堼	fgtt
次	cidr
叔	uuuy
翮	heax
瓷	cidw
咆	pcks
蓼	lncp
尔	erdx
敝	bidw
锁	sojr
璃	liwd
琍	liwd
滗	bidm
濞	bidl
立	liwa
理	liwl
珕	liwl
嫠	liwn
犛	liwn
必	bidd
弊	bidc
沘	bidb
伏	furq
眈	djov
悸	jixz
俘	furz
旦	djoa
筊	jnvx
膻	djod
呛	qlkv
阃	kymm
糁	sjmp
滧	ycdw
韵	yyld
琭	luwu
氪	keqe
耘	yyls
橐	toam
邑	yikb
钴	gujk
婧	jkno
勦	jnvl
鳚	wwac
俏	qnro
搣	mpfh
侨	qnrl
龂	ybvj
膨	pgop
韦	wwal
鲔	wwao
鳂	wwan
熳	mjhy
坉	dytt
尹	ybvp
鹏	pgon
妧	wjne
锴	kdjb
鸫	dsdn
洞	dsdk
每	mwpm
袂	mwpn
冻	dsdd
嗌	yikm
峒	tsek
峂	tsed
藕	oucy
歆	xblr
辛	xblu
镠	lqjp
锍	lqjv
飗	lqjt
新	xblj
桄	glmw
怆	ilxv
脞	coot
澈	iedw
孀	ulno
寸	cyad
咦	yiky
咿	yiky
匜	yiky
淯	yudo
怏	yhxy
千	qmpu
薛	xtcu
獐	vhqu
浴	yudk
潏	yudk
厾	duvs
钐	ujjp
哱	bakz
蚄	fhif
叭	bakb
笃	duvm
蕻	hscb
愦	kvxr
堽	ghtv
荭	hscg
叼	dnkd
吊	dnkj
骼	gegk
聒	goek
铰	jnjx
愧	kvxg
翰	hjux
韩	hjuw
鱼	yuda
渔	yuda
悝	kvxl
赧	njty
瓤	rhwg
漼	cvdf
祟	svix
男	njtl
铩	uajm
淬	cvdu
膪	vaok
穹	qsbg
鄌	thge
桩	vlmt
碾	nmun
哞	mzkn
鲶	nmax
臧	zhwi
尨	mhud
讱	rfyr
鲇	nmak
撄	ykfn
硭	mhuw
晐	gdor
鹌	andn
彳	iipr
惘	whxw
斥	iipd
铳	isje
褫	iipj
簏	luvb
枭	xnpm
翔	xlyx
涝	lcdl
箓	luvu
舻	luvu
泃	judk
斝	jxku
昴	mcoe
湨	judq
攮	nhfy
澽	judu
枚	mwmw
倡	ihro
伥	ihri
串	irll
莶	lmca
嘲	vcko
偿	ihrs
啁	vckk
螈	yrix
辕	yriy
楣	mwmo
梅	mwmm
湫	qqdh
憕	dgxa
泅	qqdr
龟	qqdv
俺	anrd
射	ueuc
挽	wjfv
烙	lohk
簕	levl
宗	zsbx
舳	vuvy
产	ijlp
婘	jrnv
箸	vuvo
瘸	qtbr
娟	jrno
邾	vuve
筑	vuvf
觇	ijle
筥	juvk
变	bmwy
绁	xpsu
蹑	npzy
禺	yuld
缬	xpsr
臬	npzm
炊	ivhr
爔	xihd
豮	ffur
烯	xihj
缄	jmsk
梆	bhme
榜	bhmf
棓	bhmk
棒	bhml
疁	lqtp
啩	gxkb
剐	gxkd
呱	gxkg
舟	vzpd
呙	gxkn
糢	momd
瘩	dabk
悛	qrxw
惓	qrxv
蹴	cuzy
惰	doxo
丹	djpa
芤	kzcv
暨	jigd
即	jige
麂	jigj
蔻	kzcy
俑	ysry
既	jigv
塈	jigt
崛	jtei
埽	sctj
螟	mkib
茹	ruck
蓐	rucc
薷	ruce
蜒	yjiz
校	xnmx
腓	fwof
肥	fwob
觜	zvvy
换	hrfd
彦	yjip
厌	yjiq
朏	fwoi
骁	xnmw
枵	xnmv
厣	yjij
黡	yjih
衍	yjii
蝘	yjin
擐	hrfy
餍	yjil
衒	xrii
梴	ijmz
雁	yjif
魇	yjig
颚	eekr
哦	eekw
呃	eekv
谍	dpym
讫	qiyq
叠	dpyq
咹	eekn
柞	zomv
绅	ufsu
参	ufsp
蒐	szcg
鄂	eeke
袁	yrty
塬	yrtx
羯	jpyv
柜	gvmj
诘	jpyk
讦	jpyg
垸	yrte
诫	jpyc
勋	xykl
挠	ncfw
蛇	yiib
礅	dyuw
砘	dyut
蚁	yiiy
劢	mdwl
轶	yiiu
炌	kdhl
蜴	yiiw
苯	bfcb
挓	vafq
褪	tvpz
绰	iosu
迴	hvzk
螂	lhie
羸	lwwf
骸	hdgr
鲢	lmaz
浞	vodr
碲	diuj
匙	uiob
肛	ghog
氐	diud
觌	diue
疐	diur
巴	bavv
粢	cidm
怍	vaxv
绔	kusk
浟	yzdw
魁	kvgu
油	yzdy
游	yzdz
暍	heol
鹖	heon
谆	vyyz
蜀	uusi
僳	surm
署	uuso
俗	surk
纾	uusl
燔	fjht
晁	icod
烦	fjhr
曷	heov
傃	surx
砺	liuw
苕	tnck
忮	vixy
岷	mbem
茏	lscl
砬	liul
盷	xmod
跽	jizx
端	drle
醍	tiyr
裱	bnpy
腺	xmou
跻	jizl
蹐	jizo
显	xmoy
蛲	nciw
雯	wfyw
骨	gulo
惯	grxr
昆	kyob
貅	xqvm
肟	wook
缂	kesg
鹍	kyon
尴	gjym
萚	tocl
酐	gjyg
昙	tjos
竫	jkll
靖	jklo
彘	vivb
霍	hoyf
竞	jkle
圻	ybtj
垠	ybtg
孢	bczs
韪	wwow
堙	ybtt
跚	ujzc
湃	pddf
趵	bczu
跞	lozl
欣	xbjr
镡	xbju
绐	ddsk
鑫	xbjj
怠	ddsx
签	qmva
箝	qmvg
珽	tkwz
洱	erde
亭	tkwd
歅	yjxr
鸭	yajn
颤	ijwr
胀	vhoi
鞁	bwgy
〇	lkvv
舲	lkvs
庳	bwgu
废	fwgd
麹	qufm
堵	duto
澳	aodd
蛤	geik
锕	aajk
跬	kvzt
虼	geiq
揶	yefe
饭	fjuy
胩	kaob
掖	yefn
揞	yefo
摧	cvff
矾	fjuf
垧	uhtk
埫	uhtk
虽	svki
半	bjdl
鲅	baad
诊	vfyp
傅	furc
俯	furc
蛑	mzin
荃	qrcw
震	vfyn
颧	qrcr
湴	bjdy
枪	qlmv
盲	mhwo
杗	mhwm
碁	qiqu
伭	xmry
佛	furf
邙	mhwe
仙	xmre
僩	xmro
樯	qlmk
胨	dsod
概	gdmv
醭	buyn
蓄	xuct
亳	bowq
玻	bowy
蓿	xucb
垆	lutu
期	qiqo
瓒	zjwr
笑	xnvy
嘴	zvky
昝	zjwo
箫	xnvs
整	vguv
筱	xnvw
绠	ggsg
拘	jufk
拒	jufj
掬	jufm
昧	mwow
场	ihtp
穿	irby
腒	juok
剟	doyd
唝	gskr
酋	qqby
蹬	dgza
镙	lojx
焆	jrho
媸	iini
廿	nmca
朱	vupw
蔫	nmch
地	dety
睬	cdom
褚	vupo
陎	uuev
棍	gymb
祝	vupe
颉	xpur
鹆	yubn
犴	anqg
窬	yubd
瘉	yubd
犏	pmnc
饯	jmuj
碱	jmuk
协	xpub
宇	yuby
寓	yuby
瘐	yuby
屑	xpuo
欲	yubr
腻	nior
膜	mood
嬉	xink
冒	mooo
睨	nioe
昵	niob
岙	aoye
脉	mooy
蒡	bhcf
媳	xinx
暱	niok
勿	wubp
	vzre
痦	wubk
肭	naon
踱	dozy
殂	cudq
杞	qimj
桤	qimj
暧	aioy
跺	dozm
蛋	djvi
鱾	jiaj
击	jiak
髻	jiak
箪	djvl
伽	gark
棘	jian
埇	ysty
疍	djvd
鲫	jiae
橙	igma
骋	igmv
柽	igmt
墉	ystl
崁	kjer
炣	kehk
腌	yjod
鸣	mkkn
庙	mngy
韫	yywm
晏	yjon
稞	kehg
赟	yywr
科	kehu
栖	qimx
槭	qimx
漷	hode
榧	fwmf
琛	ifwm
蚵	eeik
偡	vjrv
洹	hrdg
奂	hrdd
浣	hrde
峡	xxej
漶	hrdx
澴	hrdy
火	hodr
蛾	eeiw
轭	eeiv
龈	ybvg
濩	hody
抦	bkfb
垺	pztz
齐	qiwl
琦	qiwk
玘	qiwj
傢	jxru
弃	qiwc
琪	qiwb
戚	qiwx
甚	ufqv
惗	npxx
巾	jbll
耸	ssre
鳔	bnax
紧	jblx
怂	ssrx
卺	jblv
劁	qnrd
嗱	naku
徇	xyio
淖	ncdu
裛	yiwy
焖	mfhx
款	krur
亦	yiwd
奕	yiwd
弈	yiwc
髟	bnap
裔	yiwk
肋	lwol
蟫	xyiu
恢	hvxh
翚	hvxi
悔	hvxm
湩	vsda
纶	lysb
啷	lhke
猞	ueqk
唥	lhks
钮	nqji
诖	gxyt
廉	lmgn
柿	uimj
八	bapn
睹	duoo
落	lack
棂	lkmh
杠	ghmg
栻	uimg
	ghmx
棱	lkmw
柃	lkms
缔	disj
羟	qlyg
驶	uimu
铕	yzjo
蒉	kkcr
齇	vazq
鼬	yzjy
蒯	kkcd
齄	vazd
楛	kumk
狡	jnqx
钒	fjjf
凡	fjjd
阖	hemm
髫	tnak
剥	bcvd
鲦	tnam
苠	mbcm
幡	fjjt
阂	hemr
豹	bcvu
龅	bcvs
跖	vizu
趾	vizv
踬	vizr
踯	vize
詈	lisk
丕	piba
跱	vizc
缡	lisd
罹	lisf
俵	bnry
脂	vioo
鹇	xmmn
瑅	tiwr
闲	xmmm
镚	bgjo
蔺	lbcf
儦	bnrh
叩	kzke
牯	gunk
牿	gunk
髡	kyaw
偻	lzrn
煴	yyhm
鲲	kyab
毯	tjmh
檀	tjmd
陀	toeb
鼱	jkjo
踫	pgky
榃	tjmt
镜	jkje
鞳	tagk
偷	tzrd
闱	wwmw
桅	wwmv
墁	mjty
婳	hxnk
银	ybjg
核	humr
遘	gzzr
愭	qixo
拍	pdfb
赖	ldur
炘	xbhj
搞	gcfk
旒	lqfv
锇	eejw
戴	ddub
赳	jqtl
熟	uzwh
大	ddun
锷	eejk
忺	xmxr
睄	qnoo
圲	qmtq
踅	xtfr
哭	kukq
狂	klqw
樟	vhmu
杖	vhmv
孱	ijuz
羼	ijuy
馋	ijud
恓	qixx
祾	lkpw
箱	xlvo
乡	xlvp
逄	phzl
鳌	aofa
弘	hsgs
姣	jnnx
嶅	aofe
鏊	aofj
熬	aofh
螯	aofi
拗	aofl
骜	aofm
娇	jnnl
獒	aofq
鼇	aofv
敖	aofw
犴	hjqg
嗝	gekl
嗰	gekk
液	yedn
岁	svex
冶	yedk
垦	kfgt
嶟	zyec
恳	kfgx
屯	vyav
嚷	rhky
隋	sveo
氖	ndqn
拌	bjfb
龟	jydv
扮	bjfd
鳤	qrak
鲖	tsak
鬈	qrav
鳈	qrau
濬	jydo
稗	bdhu
慝	tekx
吭	hhkj
祆	xmpy
锳	ykjy
禒	xmpu
猴	hzqu
腔	qlog
峣	ycew
蛹	ysiy
鹁	boun
邈	mnze
檗	boum
臊	scom
砵	boub
礴	bouc
升	ugpc
饽	bouz
磻	bout
擘	bouu
槜	zvmn
挎	kxfk
逯	luzu
鹭	luzn
鄑	ziye
灈	qudf
防	fhef
渠	qudm
焗	juhk
秬	juhj
	jnwn
陂	bwey
橼	yrmu
猹	vaqd
凤	fgjy
騵	yrmx
珹	igwi
凭	pkrj
皞	hcbu
崾	ycen
叕	jtyy
皓	hcbk
丙	bkan
俜	pkrv
惙	ivxy
伫	vura
眷	jrjo
桊	jrjm
皖	wjbe
剜	wjbd
侏	vurv
锩	jrjv
宛	wjbv
滔	tcdj
粘	nmmk
淘	tcdf
洮	tcdd
涛	tcdc
狃	nqqi
锝	dejc
皇	hlbw
材	cdmc
套	tcds
燮	xpwy
窃	qpbd
牴	dind
贞	vflr
挝	vxfz
氛	ffqd
嫡	dink
媂	dinj
癿	qpbv
娣	dinp
卸	xpwe
珵	igww
末	moan
掭	tmfx
袭	xily
鲵	niae
万	moap
朽	xqmv
硅	gvut
硊	gvuv
洿	wudv
鋈	wudj
浯	wudk
攰	gvul
郅	viae
曌	vcog
照	vcoh
昭	vcok
憭	lnxx
至	viat
致	viaw
妲	dand
塍	igot
蒺	jicu
鳜	jtar
芰	jicy
蓟	jicd
蕺	jica
藉	jico
荠	jicl
邕	ysvb
磻	pjut
阎	yjmj
檐	yjmk
棪	yjmh
坽	lkts
阉	yjmd
珧	ycwd
瑶	ycwf
酾	udyl
锞	kejg
梴	yjmz
鎅	gdjl
闫	yjms
捕	buff
烀	huhh
和	huhk
虎	huhj
煳	huho
阍	hymo
餮	tpdl
寰	hrby
扈	huhb
啡	fwkf
筜	dhve
碜	ifup
痪	hrbd
郇	hrbe
廋	szgy
宦	hrbi
戽	huhu
罍	lwtf
卫	wwva
碛	qiur
艉	wwvm
磜	qiux
碶	qiud
乜	npvv
呇	qiuk
謦	qiuk
堇	jbna
觐	jbne
妗	jbnv
懿	yiux
尾	yium
勚	yiul
壕	hctu
饴	yiuk
曛	xyoh
瞓	xyoi
壹	yiua
射	yiuc
鹴	ulyn
霜	ulyo
舍	uerk
嚟	lwku
联	lmet
聘	pbev
锺	vsjv
峁	mcee
崞	goez
嘞	lwkl
醣	thyk
杜	dumt
羰	thyh
青	qkfo
冈	ghkx
敌	diqw
昤	lkos
椟	dumd
狄	diqh
挨	aifu
阇	dumo
葵	kvct
蒉	kvcr
鲙	kkas
袼	gepk
朏	kuoi
矿	klug
黝	yzhl
缴	jnsw
猁	liqd
痹	bibl
喝	hekv
吓	hekx
狸	liql
毖	bibb
皕	bibb
邲	bibe
腧	uuod
嚇	hekd
曙	uuoo
嗬	hekk
毕	bibu
痺	bibu
坒	bibt
呙	hekn
侔	mzrn
眬	lsol
昽	lsol
燥	zchm
屉	tiuu
鳞	lbal
泜	vidd
散	sjcw
芮	rvcn
旺	whow
喔	wokt
灌	grdf
蕊	rvcx
蕤	rvcu
镦	dvjw
涫	grdk
砰	pgup
酂	zjne
碰	pguy
煁	ifhv
庹	togi
猩	xkqu
矸	gjug
垢	gztk
唯	wwkf
汫	jkdj
喂	wwkn
襕	ljpj
溜	lqdt
芪	qicu
褴	ljpm
瑬	lqdy
讴	ouyx
浏	lqdd
郿	mwve
鹛	mwvn
眉	mwvo
舢	ujve
鎏	lqdj
玳	ddwy
聪	csex
钤	qmjv
钎	qmjq
押	yafj
祕	mipb
爽	uldx
觅	mipe
祢	mipx
戬	jmyg
铅	qmjk
雀	qtuf
怫	fuxf
豺	idvc
柴	idvm
碏	qtuo
呣	mzkm
账	vhki
覆	fuxw
戎	rsgu
悫	qtux
确	qtuy
翎	lkrx
祥	xlpy
伶	lkrs
瓴	lkrw
勰	xplx
涅	npdt
鸰	lkrn
向	xlpk
轰	hsiy
珲	hywi
碉	dnuk
屌	dnuj
阁	gemk
虹	hsig
髓	svgz
昼	vzid
砧	vfuk
瘁	cvbu
崽	zdex
辀	vziv
庄	vlgt
轴	vziy
臀	tyuo
捃	jyfk
杭	hhmj
桁	hhmi
忖	cyxc
甯	nkby
勖	xuol
煦	xuoh
昫	xuok
迟	iizi
踟	iizk
城	igti
蜣	qliv
埕	igtw
喁	ysky
盱	xuoy
旴	xuoy
冔	xuoy
赪	igtr
蹶	jtzr
噃	bokt
戮	luxg
骚	scmi
勠	luxl
痨	lcbl
哱	bokz
牢	lcbn
夸	kxdk
飓	jujb
䢛	jlzk
锔	jujk
钜	jujj
狰	vgql
逍	xnzo
芳	fhcf
鼩	qujk
力	livp
婍	qink
黹	viyd
艨	mgvu
邃	svzu
蹅	iazd
呗	bwkr
薳	yrcz
苑	yrcv
芫	yrce
砸	zauj
凉	lldx
灏	hcdr
濠	hcdu
淏	hcdt
浩	hcdk
昺	bkon
良	lldg
坪	pktp
粱	lldm
罚	fasd
塄	lgtf
辊	gyib
财	cdkc
藁	gccm
啋	cdkm
箖	lbvm
湓	pfdm
纽	nqsi
仳	pirb
掏	tcff
僻	piru
焘	tcfh
怜	lmxs
槊	uobm
舡	ghvg
操	ccfm
淟	tmdb
湉	tmdk
纷	ffsd
揼	djfu
殄	tmdp
倕	ivri
揄	yufd
沺	tmdt
添	tmdx
豳	bbuu
蘑	mocu
藦	mocu
於	wufd
霂	muym
歙	xirr
薿	nicr
捂	wufk
係	xirx
莫	mocd
傒	xird
蓦	mocm
茉	mocm
僖	xirk
俙	xirj
芹	qbcj
坏	hktb
珪	gvwt
庋	gvgy
貉	hevk
鸼	vzvn
曝	bcou
龁	hevq
胞	bcos
瑰	gvwg
遵	zyzc
潦	lcdx
嗳	aiky
哎	aikx
簝	lnvx
茋	vicd
嵫	ziey
贩	fjky
了	lnvl
芷	vicv
孔	kszv
棹	vcmu
纳	nasn
颥	ruyr
茑	nncn
尕	ganx
惩	igix
极	jimj
枅	jimk
楫	jime
蹭	cgzo
盛	igim
萱	xrcg
缊	yysm
渴	kedv
允	yyse
罨	yjsd
溘	kedm
疳	gjbg
虾	xxix
厦	xxiw
卡	qxub
轺	ycik
笏	huvw
峨	eeew
媓	hlnw
堍	tutd
跎	tozb
迆	tozy
裆	dhpe
崿	eeek
撰	vrfb
矧	ufuy
瓞	dpgu
砷	ufuu
甡	ufuu
畏	wwtn
胃	wwto
仄	zeir
扛	khfg
琢	zown
绮	qisk
抗	khfj
圩	wwty
盹	dyot
娀	ssnu
蔽	bicw
烬	jbhd
棓	bwmk
恁	nfrx
键	jmjz
桕	jqmj
栒	xymo
阄	jqmv
缢	yism
驯	xymi
异	yisc
辍	ioiy
浚	xydw
粹	cvmu
橦	ilml
闯	ilmm
蹉	cozg
骇	hdmr
种	vshv
裨	bipu
檑	lwmt
峪	yuek
妞	nqni
琅	lhwl
瑯	lhwe
穜	vshl
嘢	yekl
舐	uiqu
橡	xlmn
鄫	zgbe
楩	pmmg
卓	volu
珩	hgwi
亨	hgwl
狮	uiqj
甑	zgbw
蛉	lkis
骧	xlmy
礁	jnuh
绌	iusi
矫	jnul
骙	kvmt
櫆	kvmu
鸽	gern
葭	jxcy
颌	gerr
仡	gerq
茄	jxck
荚	jxcj
纩	klsg
藨	pcch
枢	uumx
堡	bcrt
愫	suxx
梳	uumv
谝	pmyc
蜎	yrio
币	bipj
术	uumd
煲	bcrh
粟	suxm
树	uumc
负	fudr
结	jpsk
洑	fudq
崑	kyeb
	lpdn
廪	lbgx
烈	lpdh
谣	ycyf
洌	lpdd
簉	zcvz
篓	lzvn
蜗	woin
蚬	xmie
裂	lpdy
麟	lbgl
牤	mhnw
牻	mhnp
衔	xmii
伧	chrv
静	jkfl
酊	dkyd
阻	zueq
靓	jkfe
赂	lukk
枉	whmw
掼	grfr
估	gurk
旌	jkfu
罐	grff
烝	vglh
跷	qnzw
烹	pgwh
玕	gjwg
篝	gzvr
微	wwiw
化	hxrb
鄞	ybne
姻	ybnd
欻	xuhr
瘤	lqbt
抹	mafm
篮	ljvm
珮	pwwj
绶	uzsy
苁	cscr
臼	jqpa
轪	ddid
待	ddic
葱	cscx
久	jqpn
谅	llyx
穴	xtbb
虔	qmhw
卬	yhpe
蟑	vhiu
涯	yadt
酺	puyf
讵	juyj
谱	puyo
跗	fuzc
趺	fuzf
谄	ijyj
缇	tisr
谗	ijyd
馄	hyub
儴	xlry
昏	hyuo
縢	tgox
像	xlrn
扼	eefv
哏	hfkg
兑	dvbe
唝	hskr
伤	uhrl
翱	aobx
胳	geok
吽	hskn
膈	geol
哄	hskb
痧	uabu
佝	gzrk
楱	zzmt
珍	vfwp
赒	vzkk
咒	vzkj
鳟	zyac
肺	fwol
驺	zzme
瑱	vfwb
酬	izyv
睄	ucoo
攽	bjbw
颁	bjbr
墡	ujtk
瘢	bjby
埏	ujtz
诅	zuyq
糈	xumo
宠	isbl
承	igvn
栩	xumx
秭	zihp
瓻	iixw
耢	lcll
幞	fujn
肆	siay
兕	siae
刹	iaxd
敩	xnxw
筇	qsve
肖	xnxo
削	xnxd
燊	ufhm
懵	mgxo
	pojd
閪	hwmx
钷	pojk
耆	qilo
觑	quhe
灞	bado
疭	zsbr
懞	mgxu
栅	cemc
焌	quhw
鸧	chrn
馑	jbua
锠	ihjo
砝	faus
帔	pwjy
熏	xyph
裸	lopg
锫	pwjk
槟	bkmb
靓	llfe
鲝	vaya
裨	pipu
盈	yknm
摄	uefy
态	tdtx
碳	tjuh
谪	veyk
着	veyo
邳	pipe
郫	pipe
揲	uefm
折	uefj
媖	ykny
霅	vayk
辗	nmin
镝	dijk
斌	bbwv
铦	tmjk
漕	ccdo
囝	jmkz
滪	yudr
玢	bbwd
帨	uvje
棼	ffmd
粪	ffmb
见	jmke
贱	jmkj
渝	yudd
淤	yudd
钿	tmjt
贵	gvvr
焚	ffmh
悉	xipx
焐	wuhk
裼	xipw
陌	moeb
芥	jpcl
禧	xipk
谿	xipk
快	kkxn
夕	xipd
奚	xipd
禊	xipd
犹	yzqy
盍	hetm
珥	erwe
垎	hetk
赫	hetd
龆	tnvk
枹	bcms
垈	ddrt
裰	dopy
髹	xqam
罩	vcsu
骘	viem
职	vieb
峙	viec
濛	mgdu
陟	viep
呈	igkw
肌	jioj
憺	djxk
惔	djxh
惮	djxl
吆	ycky
咬	yckx
吓	xxkx
嚇	xxkd
狁	yyqe
氲	yyqm
呷	xxkj
左	zoug
钍	tujt
莪	eecw
苊	eecv
嫜	vhnu
煌	hlhw
萼	eeck
豁	hobk
垂	ivpa
綦	qiqx
偎	wwrn
赜	zekr
欺	qiqr
咋	zekv
奀	nfbd
枸	gzmk
搡	shfm
构	gzms
伪	wwrw
凹	wala
竦	sslu
猗	yiqk
锦	jbjj
荓	pkck
楯	dymo
艺	yicv
颓	tvhr
啜	ioky
缣	jmsn
煺	tvhz
嘧	mike
胲	hdor
咪	mikm
髦	mcam
熄	xihx
熻	xihx
狼	lhql
呤	lkks
圐	kukf
镯	voji
	vojo
乍	vapa
嘭	pgkp
市	uiwj
蹂	rzzm
躺	thuk
另	lkkl
○	lkkk
弨	icgk
塥	getl
璬	jnww
交	jnwx
斠	jnju
暌	kvot
卣	yzlk
夹	jxan
郊	jnwe
由	yzla
圪	getq
戛	jxag
宫	gsbk
咙	lskl
奶	ndnn
速	suzu
哢	lskc
褓	bcpm
铒	erje
啁	tnkk
腨	uroe
蹜	suzb
锋	fgjf
鼐	ndnv
赎	uukd
弦	xmgy
罔	whkw
网	whkx
捩	lpfq
踢	tizw
盛	ugim
泾	jkdg
堌	gutk
净	jkdl
鳎	taax
莓	mwcm
饧	xkup
愀	qnxh
悄	qnxo
铮	vgjl
音	yblo
野	yell
硎	xkud
慭	yblx
	qscl
钲	vgjv
省	xkuo
鄗	hcwe
匈	xsbk
嫖	pnnx
筵	yjvz
僦	jqry
损	syfr
呔	ddkt
鳓	leal
呆	ddkm
吋	cykc
狩	uzqc
犍	qmnz
张	vhgi
痖	yaby
佯	yhry
仰	yhre
孅	qmnj
丫	yabl
匹	pike
璞	puwn
彪	bnhp
侪	idrl
吡	pikb
窆	bmbf
熛	bnhx
嶙	lbel
噼	piku
軚	tdit
滏	fuda
茕	qscu
涪	fudk
埝	nmtx
盂	yuym
雩	yuyk
鄅	yuye
邘	yuye
谕	yuyd
磲	quum
闳	hsms
谀	yuyy
愚	yuyx
欤	yuyr
荽	svcn
嶲	jrev
卿	qkpe
赆	jbkd
佴	ndre
腕	wjov
凹	aola
椆	vzmk
骤	vzmn
斟	vfqu
归	gvle
皲	jyby
嚓	cakx
瓣	bjlu
圈	qrkv
拧	nkfd
耰	yzlw
佰	bdrb
冲	isdv
漴	isdx
嘘	xuky
壤	rhty
铵	anjn
摛	iifd
孓	jtvn
臃	ysof
裎	igpw
脖	booz
嫪	lcnp
啥	uakk
笙	ugvu
祫	xxpk
姥	lcnb
膊	booc
蕞	zvcy
蓖	bicb
芘	bicb
苾	bicb
犋	junb
娵	juny
婆	podn
锜	qijk
娠	ufnn
勐	mgzl
孟	mgzm
泼	podd
泊	podb
颀	qijr
婶	ufnu
的	debu
一	yiaa
是	uior
了	levl
不	buad
在	zdut
有	yzuo
个	gerl
人	rfpn
这	vezw
上	uhla
中	vsll
大	daun
为	wwdd
来	ldan
我	wopd
到	dcad
出	iuvk
要	ycxn
以	yivr
时	uioc
和	hehk
地	dity
们	mfrm
得	deic
可	kedk
下	xxab
对	dvyc
生	ugpf
也	yevv
子	ziva
就	jqwy
过	gozc
能	ngsb
他	tary
会	hvrs
多	doxx
发	favd
说	uoye
而	eral
于	yual
之	vidn
用	yspl
年	nmpl
行	xkii
行	hhii
家	jxbu
方	fhdw
后	hzpk
作	zorv
成	igwv
开	kdac
面	mmaa
好	hcnz
小	xnld
心	xbdd
前	qmbd
所	sopj
法	fads
如	runk
进	jbzj
着	voyo
同	tskk
经	jksg
分	ffbd
定	dkbr
都	dzle
都	dule
然	rjph
本	bfaa
还	hrzb
还	hdzb
其	qiqb
其	jiqb
当	dhxe
动	dsel
两	llad
点	dmlh
从	csrr
问	wfmk
里	lila
主	vudw
天	tmad
高	gcwk
去	quts
现	xmwe
长	vhpn
长	ihpn
此	civb
三	sjae
将	jldc
无	wuav
全	qrrw
明	mkoo
日	rika
些	xpve
些	sove
看	kjuo
公	gsbs
等	dgvc
正	vgav
外	wdxb
想	xlmx
间	jmmo
把	bafb
情	qkxo
者	velo
没	mwdy
重	ispa
那	nave
因	ybkd
样	yhmy
学	xtxz
应	ykga
手	uzpl
但	djrd
关	grbt
二	eraa
处	iuwb
门	mfdv
并	bkbk
口	kzla
么	mops
么	meps
位	wwrl
头	tzdd
话	hxyk
很	hfig
再	zdar
身	ufpp
内	nwld
平	pkau
被	pipy
被	bwpy
给	gwsk
别	bpkd
月	ytpa
真	vfub
少	ucxp
水	uvln
最	zvoy
部	bule
何	herk
安	anbn
接	jpfn
报	bcfy
才	cdap
体	tirb
西	xiaa
你	nirx
表	bnfy
目	muka
老	lclb
四	sike
路	luzk
更	ggan
走	zztr
比	bibb
总	zsbx
光	glxw
任	rfrr
原	yrix
便	pmrg
便	bmrg
教	jnlw
难	njyf
山	ujlk
数	uumw
代	ddry
色	sedb
非	fwla
服	fuoy
求	qqad
风	fgjx
太	tddd
万	wjap
各	gewk
算	srvc
王	what
许	xuyw
连	lmzi
活	hodk
该	gdyr
则	zekd
女	nvva
马	mava
强	qlgi
言	yjwk
条	tnwm
特	tenc
感	gjxx
转	vriv
传	irrv
民	mbvv
白	bdpo
它	tabb
车	jual
车	ieal
反	fjpy
却	qtte
流	lqdv
且	qpla
论	lyyb
让	rhyu
决	jtdn
满	mjdl
空	ksbg
听	tkkj
容	rsbk
军	jybi
办	bjld
林	lbmm
客	kebk
战	vjlg
单	ijbl
领	lkrr
亲	qblm
双	ulyy
爱	aipy
随	svez
足	zukr
落	lock
根	gfmg
怎	zfvx
持	iifc
送	sszt
准	vydf
红	hssg
早	zcou
故	guuw
找	vcfg
调	dnyk
断	drmj
设	ueyy
拉	lafl
周	vzkk
运	yyzs
谈	tjyh
钱	qmjj
乐	lepd
推	tvff
若	rock
呢	nekb
乎	hupl
称	ifhx
品	pbkk
黑	hwlh
存	cyuz
图	tukd
曾	zgbo
曾	cgbo
装	vldy
九	jqpv
况	klde
热	refh
刚	ghkd
群	qyyy
类	lwmd
黄	hlcb
查	vamd
查	iamd
破	pouy
谁	uwyf
句	gzbk
仍	rgrn
龙	lsud
苦	kuck
朝	icuo
阿	eeek
阿	aaek
错	cojo
差	idyg
参	cjsp
参	cfsp
选	xrze
汉	hjdy
诉	suyi
密	mibe
案	anbm
修	xqrp
区	oukx
料	lnmu
帮	bhfj
考	kclv
规	gvfe
团	trkc
冷	lgds
派	pddn
春	iyfo
乱	lrqv
楼	lzmn
怕	paxb
铁	tpju
否	fzbk
兰	ljbs
怀	hkxb
买	mdvd
忙	mhxw
列	lpdd
杀	uaxm
脑	ncok
某	mzgm
顺	uyir
讨	tcyc
追	vvzk
草	cccu
堂	thxt
托	tofq
寻	xyec
波	body
略	lttk
藏	zhci
藏	chci
肯	kfvo
盘	pjvm
毛	mcpv
哈	hakk
农	nsdn
配	pwyj
杂	zajm
孙	syzx
抓	vxfv
顿	dytr
律	lviy
朋	pgoo
窗	ilbw
软	rrir
压	yaid
跑	pczs
困	kykm
梦	mgmx
旁	phwf
康	khgn
恩	enkx
怪	gkxt
宁	nkbd
您	nbrx
娘	nlnl
佛	forf
普	pubo
夏	xxaw
兄	xske
率	ukwu
牛	nqpl
卷	jrjv
策	cevn
肉	rznr
欧	oukr
浪	lhdl
宽	krbe
抽	izfy
评	pkyp
挂	gxft
尊	zybc
乃	ndvp
混	hydb
塞	sdbt
横	hgmb
择	vdfl
巧	qngv
赞	zjnr
怒	nunx
票	pnxx
穷	qsbl
扫	scfe
瑞	rvwe
促	curr
妙	mnnu
卡	kaub
森	sfmm
诺	noyk
丢	dqps
灭	mpah
绕	rcsw
吹	ivkr
括	kofk
瓦	waad
滚	gydy
腾	tgom
萨	saci
宾	bbbb
亏	kvev
奥	aopd
恰	qxxk
丧	shun
匆	csbd
跨	kxzk
搜	szfy
夹	gaan
翠	cvxu
暖	nroy
润	rydw
吞	tytk
摄	npfy
钻	zrjk
俩	lxrl
跌	dpzu
昂	ahoe
擦	cafx
刷	uxud
喷	pfkr
翁	wgbx
贼	zwku
凑	czdt
哦	ookw
囊	nhay
僧	sgro
嫩	nfnw
崩	bgeo
坑	kgtj
哟	yoku
剖	pzld
窜	crbi
瞥	ppdo
晒	udox
虐	ntha
戳	ioxg
谬	mqyp
揣	ikfe
炯	jshk
嗯	onkx
嗯	ogkx
拴	urfw
拽	vkfy
嗲	dxkx
耨	nzlc
呣	omkm
诶	eiyu
扽	dfft
剋	kwud
得	dwic
氹	tfvu
冧	lfbm
欻	ixhr
辩	bmlu
毽	jmmz
鼯	wujk
摩	mogu
颜	yjir
凰	hljw
吨	dykt
茆	mcce
徉	yhiy
陵	lkew
灼	vohu
硌	geuk
险	xmea
黍	uuhu
障	vheu
黪	cjhp
镖	bnjx
扶	fuff
舂	isfj
轧	vaiv
鼓	guuy
蛭	viit
元	yree
站	vjlk
湟	hldw
汀	tkdd
眯	miom
嗐	hdkk
蕾	lwct
避	bizu
墟	xuty
榻	tamx
杆	gjmg
椎	vvmf
骀	tdmk
脾	piou
邯	hjge
沙	uadu
庚	gggn
澥	xpdn
抑	yife
咤	vakq
物	wunw
溧	lidm
柬	jman
单	djbl
饥	jiuj
沣	fgdf
文	wfwx
胜	ugou
肝	gjog
彷	phif
萌	mgco
式	uiyg
叻	lekl
富	fubt
扁	bmhc
瞵	lbol
豫	yusn
嵅	hjek
鹜	wusn
莉	licd
驮	domd
妈	manm
厮	siij
屁	piub
契	xpfd
奇	qidk
浥	yidb
屏	bkuk
郗	xixe
札	vamv
严	yjyp
姓	xknu
议	yiyy
筚	bivu
淞	ssds
洇	ybdd
柱	vumv
檩	lbmx
茜	xicx
滨	bbdb
砆	fuuf
泸	ludu
硌	louk
缓	hrsy
缯	zgso
晊	viot
疖	jpbe
琄	xrwo
京	jkwx
澎	pgdp
鳗	mjay
闾	lvmk
琮	cswx
牵	qmdn
遭	zczo
碎	svuu
侵	qbry
邬	wuwe
般	bjvy
扇	ujhx
消	xndo
玉	yuwd
踔	iozu
吱	ziky
沾	vjdk
拾	uifk
鞬	jmgz
欂	bomc
糜	migm
纪	jisj
鸾	lrwn
妨	fhnf
爸	babb
蛛	vuiv
鲚	jial
胄	vzyo
喘	irke
谵	vjyk
飕	szjy
蘖	npcm
熨	yuuh
旱	hjog
旬	xybo
炒	ichu
艄	ucvo
蕴	yycm
危	wwdv
扛	ghfg
零	lkys
舴	zevv
暮	muco
婀	eenk
意	yilx
鱿	yzay
吡	bikb
河	hedk
翻	fjpx
榴	lqmt
莒	juck
英	ykcy
充	iswe
喺	xikx
硿	ksug
淹	yjdd
乐	ycpd
瑟	sewb
迦	jxzk
轱	guik
睛	jkoo
性	xkxu
诇	xsyk
谜	miyz
记	jiyj
起	qitj
椹	ufmv
较	jnix
撵	nmfi
蟋	xiix
诠	qryw
召	vcdk
煊	xrhg
蚶	hjig
隳	hvex
畲	uert
稂	lhhl
剞	jidd
棵	kemg
笠	livl
殉	xydo
移	yihx
蹋	tazx
棽	ifmv
町	tktd
蹄	tizj
固	gukk
燧	svhz
朴	pomb
搬	bjfy
候	hzru
什	ufru
阈	yuma
件	jmrn
晰	xioj
扃	jshk
委	wwhn
烟	yjhd
窿	lsbu
已	yivv
桦	hxmu
堤	ditr
呀	yaky
讪	ujye
舶	bovb
芜	wucw
骡	lomx
惑	hogx
芋	yucy
栖	ximx
伦	lyrb
燕	yjnh
薜	bicu
俪	lirl
仕	uiru
劏	thxd
焦	jnrh
股	guoy
畴	iztc
呙	wokn
襄	xlwy
棕	zsmx
巍	wweg
婴	ykkn
屼	wuew
笺	jmvj
柢	dimd
雨	yuad
寞	mobd
铪	kejk
癣	xrby
呵	kekk
	yjlt
价	jprl
依	yiry
漯	tadx
桔	jumk
械	xpmc
汤	uhdp
遇	yuzy
綮	qkhx
侩	kkrs
钵	bojb
癸	gvvt
涑	sudu
资	zidr
窒	vibt
壶	huuy
气	qipv
庾	yugy
殁	mody
邵	ucde
虱	uivi
趟	thtk
邪	yeye
桂	gvmt
眺	tnod
霉	mwym
霏	fwyf
蛆	quiq
棋	qimb
胂	ufou
逅	hzzk
省	uguo
劲	jbvl
糗	qqmq
蝗	hliw
诳	klyw
隅	yuey
嫔	pbnb
泡	pcds
枕	vfmv
淠	pidl
畤	uitc
围	wwkw
渚	vudo
忡	isxv
坦	tjtd
伍	wurw
狭	xxqj
澌	sidj
挚	vifu
嚎	hcku
喜	xiuk
腆	tmob
底	digd
秧	yhhy
胗	vfop
逦	lizl
界	jptl
祛	qups
泠	lkds
藩	fjct
偬	zsrx
副	fuad
她	tany
吗	makm
晱	ujoh
㓥	tsxd
碴	iaud
捍	hjfg
黠	xxhk
镐	gcjk
字	zibz
蚧	jpil
雒	lowf
钖	yhjp
暴	puou
粘	vjmk
栗	lixm
迤	yizy
虺	hvwi
钾	jxjj
璧	biuy
芙	fucf
标	bnmx
诂	guyk
廷	tkzr
赶	gjtg
居	juuk
谔	eeyk
愈	yurx
涵	hjdk
蛰	vefi
涌	ysdy
瞭	lnox
星	xkou
迥	jszk
畸	jitk
簰	pdvu
翌	yixl
镕	rsjk
椸	yimy
驸	fumc
俩	llrl
匝	zakj
岂	qiej
奏	zzft
赢	ykwf
锶	sijx
鲤	lial
切	qpqd
兼	jmbn
阔	komk
惊	jkxx
卐	wjvv
鲌	baab
擝	mgfm
肤	fuof
癖	pibu
茫	mhcw
蕲	qicj
穸	xibx
萍	pkcp
艾	yicx
杷	pamb
幔	mjjy
事	uial
渐	jmdj
鸨	bcbn
祭	jipx
殒	yydr
谷	gubk
菝	bacd
皦	jnbw
架	jxlm
辐	fuit
班	bjww
澶	ijdd
阼	zoev
忤	wuxw
沪	hudh
惶	hlxw
祉	vipv
粒	liml
丘	qqqj
夷	yian
儇	xrry
瞳	tsol
究	jqbj
米	midm
肪	fhof
粑	bamb
浇	jndw
呋	fukf
纫	rfsr
齿	iivk
哀	aiwy
禹	yupd
爬	pavb
沛	pwdl
镵	ijjd
蒗	lhcl
哧	iikd
暄	xrog
胪	luou
津	jbdy
秘	bihb
哩	likl
廖	lngp
啖	djkh
驼	tomb
洋	yhdy
淌	thdk
阆	lhml
颖	ykbr
编	bmsc
醑	xuyo
赤	iitd
蚌	bhif
淅	xidj
岢	keek
橹	lumo
锾	hrjy
蟊	mcsi
篙	gcvk
诋	diyd
薇	wwcw
拔	bafd
历	liil
荷	heck
葡	pucf
免	mmdv
咖	kakk
侈	iirx
员	yrkr
登	dgva
瞑	mkob
喧	xrkg
唁	yjkk
篁	hlvw
昨	zoov
噫	yikx
汇	hvdk
匡	klkw
淖	vodu
扎	vafv
属	uuuy
离	liwd
泌	bidb
胆	djod
锢	gujk
未	wwan
镏	lqjt
汩	yudo
彷	fhif
吧	bakb
薨	hscb
认	rfyr
录	luvu
沮	judq
愿	yrix
竺	vuve
稀	xihj
模	momd
佣	ysry
堲	jigt
骣	ijmz
鹗	eekn
役	yiiy
砥	diud
砾	liul
竟	jkle
锌	xbju
鞴	bwgy
龄	lkvs
逵	kvzt
墒	uhtk
付	furc
氓	mhwm
据	jufk
锣	lojx
瘀	yubd
牺	xinx
寤	wubk
胭	yjod
涣	hrdd
厄	eeiv
循	xyio
衣	yiwy
辉	hvxi
舌	ueqk
铀	yzjy
枯	kumk
帆	fjjf
核	hemr
姑	gunk
馧	yyhm
墘	qmtq
聱	aofe
咯	gekk
博	bouc
炬	juhj
完	wjbe
住	vurv
亵	xpwy
污	wudk
瞠	igot
匪	fwkf
砌	qiud
钟	vsjv
毙	bibb
暑	uuoo
呵	hekk
胧	lsol
彭	pgup
艰	jmyg
令	lkrs
格	gemk
咏	ysky
锯	jujk
遂	svzu
贝	bwkr
梁	lldm
筻	ghvg
於	yufd
摹	mocu
翕	xirx
暴	bcou
芝	vicv
机	jimj
柩	jqmj
冽	lpdd
仓	chrv
订	dkyd
啁	vzkk
癍	bjbw
黢	quhw
柄	bkmb
粉	ffmd
系	xipx
笤	tnvk
匣	xxkj
憩	qiqx
啧	zekr
伟	wwrw
囹	lkks
睽	kvot
憔	qnxh
啤	piku
语	yuyk
晚	wjov
伯	bdrb
吁	xuky