的	kfq
一	t
是	kto
不	ti
了	s
在	biy
有	bf
我	ibn
人	w
他	ov
这	qa
个	wi
们	odv
来	tr
大	m
为	qfq
上	iit
时	kbv
能	cfff
以	iqw
和	ph
要	jx
说	gwj
就	qhpq
到	tcyo
地	yv
可	th
那	sbs
国	huq
会	wyc
也	v
中	hi
生	iu
子	nst
著	vyk
出	dd
你	ozp
家	ap
多	zz
得	pktb
年	zb
用	ffb
么	ic
学	ean
下	tq
去	yc
工	ytt
都	yks
于	tb
之	a
自	kikx
对	xb
过	ba
方	qqf
作	oziy
好	xn
成	nf
小	p
样	mwu
看	uk
分	ws
十	bti
天	tm
面	tl
发	dxq
然	zmr
同	dth
从	ww
后	zth
动	ycf
种	phi
所	zsz
没	egx
她	xv
三	u
如	xh
两	tdww
又	x
此	ofv
事	thb
道	wka
还	tia
而	td
业	pow
起	yosd
主	qu
二	y
行	py
现	udo
数	rxx
经	ccy
心	e
因	hm
想	mke
但	okt
很	psc
些	ofy
点	ihr
当	ps
物	bfo
只	hw
与	tgt
长	nw
前	wfo
水	ir
本	mt
开	tv
民	sin
法	eyc
其	vwx
见	do
进	va
定	ato
实	awm
日	k
把	bj
知	zmh
最	kkx
问	dh
等	zyb
体	omt
高	qhdh
已	sd
各	xhz
外	zi
里	ky
意	yke
由	l
头	wm
力	fsi
四	ho
无	tn
正	to
使	othx
气	uztg
做	ojx
部	yhs
理	uky
表	uc
全	wu
将	izb
相	mkv
重	itky
间	dk
加	fh
或	nht
手	b
常	pahd
情	iuf
及	gq
己	sdx
明	kf
应	qe
它	af
机	mg
产	yi
便	otkx
度	qvx
回	hh
位	oy
向	idh
儿	o
公	wc
少	pi
形	tvp
电	lkd
老	yf
候	oism
果	kmx
量	ktky
几	gig
第	zgii
什	obv
活	eij
走	yoz
直	bk
比	if
化	of
身	idui
义	qxx
先	bo
线	cn
平	yw
美	wum
利	po
文	qqx
原	tkp
再	ud
给	cwh
新	ymz
代	on
变	qpx
西	j
解	zfsb
关	wmz
才	bi
立	yet
并	wv
边	fa
政	tox
元	yo
别	hfo
员	hd
真	bkw
声	yj
合	wh
教	ynx
话	gij
每	zjw
太	mq
更	tkx
五	uts
叫	hii
内	dw
月	f
百	tk
甚	vwd
女	xcit
至	tcy
呢	hjf
次	wzw
题	ktod
受	rax
社	ay
放	qx
山	did
入	wiqx
九	g
计	gb
今	wa
战	ihn
东	np
怎	ziye
被	aix
总	whe
结	cyh
则	dov
听	hz
眼	ksc
打	bt
庭	qiyg
名	zh
光	pto
路	jxh
车	bnb
必	ei
命	whs
反	zx
角	zf
性	iiu
书	ssiq
六	eqw
军	ab
接	byx
处	xi
者	yk
色	zj
八	wiq
世	vd
像	ozhp
期	vwf
求	brq
设	ggx
白	kik
许	gzb
运	yca
亲	ym
指	bfk
任	oiy
图	hxw
通	cfa
觉	eado
论	gwf
爱	rabx
条	xmz
式	ny
门	dqis
例	otzo
界	lwo
即	scs
且	kdu
海	ezjw
港	evwj
万	ts
吗	hg
字	an
记	gsd
快	isw
象	zhp
建	bgc
算	zkv
提	bkto
组	ck
称	pzp
近	za
却	ycs
花	vof
共	vw
带	vad
往	pqu
观	xdo
完	ayo
场	ygo
感	nite
风	gx
件	obv
类	rmz
难	xou
特	byb
住	oqu
信	ouh
决	wsw
程	phu
示	ypz
空	awy
号	htg
影	kqhp
何	oth
展	jvc
北	iyf
认	gw
制	bdo
思	le
质	zbd
科	pwb
吃	hzg
较	bex
半	wb
市	qd
球	ubrq
取	kx
望	qfu
强	ghl
流	eqcp
笑	zim
片	ziis
坐	wwy
该	gqcw
王	uyt
验	gwe
阶	swo
交	exz
党	paj
区	sx
早	kb
保	ohm
造	bha
千	ib
极	mgq
热	bgqr
写	atgt
队	sw
管	zah
七	ntd
根	msc
目	khy
父	wx
南	bdwy
安	ax
孩	nqcw
资	wzwd
非	ouu
神	aki
改	six
切	ns
师	otd
妈	xg
金	n
转	bygq
若	vbh
死	tzf
品	hhh
清	euf
满	evtw
报	bsx
农	ac
单	wkb
办	fw
级	cgq
马	gsgt
远	yoa
吧	hj
收	iix
步	op
据	bjj
连	bac
容	arh
段	zugx
争	zsi
离	qxdc
服	fsx
跟	jsc
视	ado
试	gny
究	awg
告	bhz
音	ykz
导	jb
统	cqco
积	phw
治	ech
香	pkz
张	gnw
士	ybtx
识	ghw
易	kfo
须	ptd
虽	hl
照	kshr
料	rwb
似	oiqw
器	hhmh
苦	vj
始	xch
故	jxv
乐	fp
整	mhxo
术	mqx
革	vlx
精	ruf
火	rww
传	oygq
需	rtd
友	bxc
务	xfz
确	jzf
约	cfq
研	jtv
系	icp
领	watd
失	im
除	swmv
请	guf
份	ows
未	bw
消	epf
越	yoni
具	kw
曾	wlk
志	ye
商	edwh
够	fhzz
谈	grr
达	ma
足	hoz
深	eawm
项	ytd
备	xl
钱	nn
轻	bcy
青	uf
府	qob
般	fgxv
石	jth
校	mex
演	eatw
准	wou
持	bybv
兴	ew
众	www
包	fjc
食	wqsc
增	ywlk
响	hidh
船	fgh
病	qtdw
细	cl
飞	gwx
答	zwh
仍	ogv
习	ssw
值	obk
列	tzo
米	rwm
亦	qp
功	yfv
让	gi
率	qcrb
晚	kzho
参	cmp
母	jwx
节	vs
价	owo
调	gfyh
土	ybt
讲	gv
另	hf
河	eth
院	sayo
房	qjq
找	bn
济	eqo
基	vwy
拿	whb
星	kiu
言	uh
英	vdm
息	ke
装	iyqc
举	ewb
育	qcfz
温	ekl
随	sbfa
黑	lyr
群	sihu
买	swm
欢	xzw
画	tld
史	hx
劳	vaf
夜	qoxq
集	oum
站	yih
衣	qc
落	vexh
团	hbi
底	qfnq
规	mdov
联	kwm
谁	gou
古	jbh
夫	myw
哪	hsbs
首	wk
选	boa
际	syp
司	sthc
啊	hsth
推	bou
刻	qcwo
均	yfw
喜	yhwh
引	giv
红	cy
留	fsl
倒	otco
渐	ebz
证	gto
养	wmo
读	gywm
存	bin
官	ah
呀	hsii
格	mxh
怕	ikv
断	rdz
您	ozpe
树	mxb
纸	cfn
送	wma
令	waz
广	q
专	ygqx
干	ytb
久	zq
岁	dz
注	equ
低	ofnq
支	bx
简	zdk
显	kp
医	szm
愿	tkpe
族	qzzm
初	as
历	tf
境	yyko
爸	wxj
铁	nim
势	bgqf
环	uti
乎	iwb
标	mypv
议	gqx
斗	wbx
差	wuy
适	ija
屋	jtcy
助	kfv
织	chw
皮	ix
块	ysw
哥	thth
微	pdtx
朋	ff
客	axh
黄	vlw
依	oqc
紧	oxcp
油	el
拉	by
假	ojyx
续	cywm
速	mha
草	vkb
局	jsh
华	ofb
右	bh
吸	hgq
脸	fwe
阳	sk
终	cxw
考	ytg
素	ucp
破	jix
脚	fycs
属	jild
敌	ijx
况	wj
权	mx
刚	dxo
围	hbs
技	bbx
费	god
置	lbk
句	fhc
城	ynf
严	tpi
止	oiit
男	lf
忙	iq
态	mqe
害	abh
排	bouu
错	nvk
穿	awsi
密	aeid
致	tcyx
钟	nhi
弟	wgii
急	zse
赛	avwd
兵	ztw
供	ovw
诉	gzq
台	ch
否	tih
静	ufzi
睡	kity
左	byc
查	mkt
林	mm
压	tyq
某	vm
胜	fiu
划	no
厂	tti
察	azyp
击	bd
洲	eep
午	zbx
周	fyh
绝	czj
停	oqht
继	crd
帝	ead
艺	vg
伤	ozf
居	jj
鱼	lzlt
跑	jfj
语	guh
派	ezc
念	wae
纪	csd
叶	hb
奇	mth
卖	ywm
余	wmz
班	uou
省	pik
唱	hkk
味	hbw
德	pble
室	atcy
充	qco
圆	hhd
雨	r
防	sq
银	nsc
负	zd
责	udz
毛	uiyd
竟	yko
爷	wxs
帮	bsd
液	eqoq
射	idub
配	jtsd
酒	ejt
睛	kufv
律	pb
状	imv
构	mfc
尽	jqw
血	il
饭	zzx
歌	thtw
布	bdc
采	rm
赶	yoy
冷	wwa
怪	ixy
靠	bhou
委	px
效	exx
坏	yti
复	zkx
投	bgx
慢	iklx
灯	rt
木	mbw
获	vpm
案	axm
双	xx
洋	ewu
层	jyc
含	wah
护	bqj
弹	gwkb
待	pyb
修	oixp
尤	nq
昨	kziy
突	awmz
讨	gbv
村	mb
沙	epi
批	bif
减	wnih
货	ofd
课	gkm
啦	hby
坚	oxy
敢	skx
亮	qhag
预	csid
笔	zu
误	ghtm
既	scso
述	mqa
短	zmtw
汽	eu
拍	bkv
营	vahh
顶	ttd
席	qvd
趣	yokx
限	ssc
药	vcfq
固	hjc
植	mbk
警	vfhh
维	cou
抗	bqg
忽	foe
概	msco
呼	hiwb
章	ykb
脑	fqxd
互	tjt
股	fgx
乱	ijd
座	qwwy
距	jss
武	ton
剧	jjo
顾	tgtd
创	wgo
印	fts
希	xbd
亚	tp
激	ekqx
烧	rnto
杂	gm
职	khw
输	bwfo
练	cnsw
端	ydtd
朝	bkbf
替	mmk
险	swe
免	zho
施	qzv
独	pl
缺	zbdw
旧	ik
景	kqhp
妇	xsv
旁	eaq
姐	xk
源	etkp
阵	sbv
祖	akv
仅	ox
谓	glf
担	bkt
测	edo
江	ey
异	jv
乘	piyf
曲	hv
牛	bib
跳	jor
换	bzdm
富	athl
惊	iqhp
遇	kdia
困	hmc
按	bax
略	lxh
恶	tpe
永	qsr
良	qsc
型	tvoy
嘴	hoff
园	hyo
怀	iti
乡	c
检	mwe
克	jo
升	iv
封	yyb
板	mzx
店	qih
守	abz
陆	sbd
背	iyff
救	brqx
玩	uyo
烈	tzor
礼	ad
善	wuwh
痛	qcf
杀	xm
括	bij
毒	ujw
戏	xnv
攻	yx
苏	vfw
普	wpk
透	pga
途	wmac
肉	dww
肯	ofz
沈	eao
烟	rhm
田	lhb
优	onq
娘	xqsc
付	ob
汉	ex
败	dx
幸	ywy
春	mk
暗	kyk
绿	csir
尺	jq
模	mvkm
熟	qhnr
伟	obs
掉	bikb
央	dm
婚	xfnk
录	sir
野	kyci
益	wwl
丽	tdqq
材	mbi
散	vfx
票	jyp
镜	nyko
喝	hkfd
序	qcsi
菜	vrm
判	wbo
骨	gf
巴	jsid
楼	mrx
湾	eqpg
摇	brzd
附	sob
露	rjxh
策	zmd
款	yypw
卫	st
欧	sxzw
罢	lyc
盛	nfl
诺	gvbh
楚	mmso
庄	qy
咱	hk
逐	pa
染	egm
疑	fzmo
季	pn
移	pzz
虫	lhiq
零	rwa
床	qm
健	obg
街	pyyy
雪	rs
旅	qzc
粉	rws
介	wo
顺	ptdv
忘	qez
占	ih
斯	vwz
丝	cct
训	gp
灭	trz
云	ycz
县	kc
福	athl
鼓	yhwx
折	bzv
窗	awhx
夏	tkxz
冲	whi
宣	atkt
翠	ssqb
降	sxb
游	eqzn
针	nb
酸	jtcx
岸	dty
愈	wfoe
桥	mimo
钢	ndx
追	iha
氧	uwu
舞	zvzb
堂	pahy
闻	dkc
弄	uv
宝	auq
危	ztg
妹	xbw
协	bfw
哭	hhm
喊	hnih
谢	gidb
洗	ebo
超	yosh
硬	jtkx
浪	eqsc
范	veg
懂	iviy
挥	bab
宗	ayp
甲	kix
燃	rzmr
鲜	lwu
贵	ld
评	gyw
凡	gqc
架	fhm
临	ozl
棉	mkd
耳	ktou
馆	zahv
齐	qo
彩	rmp
抽	bl
轮	bwf
迎	fsa
努	xxf
翻	irls
遍	qjda
抱	bfj
触	zfl
孔	nd
徒	pyo
毫	qhau
访	gqv
沿	egh
阿	sth
唯	hou
搜	bfix
培	yyh
盘	fl
州	ep
企	woz
赞	bobd
丰	bui
灵	sr
康	qbr
纷	cws
京	qhp
亡	qqd
泥	ejfv
波	eix
倍	oyh
罗	lz
诗	gyb
混	ekif
仔	onv
尚	pdh
招	bsh
廿	vvt
副	thlo
姑	xj
径	pcy
税	pwj
匪	souu
释	irxb
圈	hwmg
惯	ijbd
枪	mwg
氏	fn
握	bjty
私	pc
蛋	sol
刀	ssi
巨	ss
承	sur
财	dbi
退	sca
额	axhd
威	nitx
绍	csh
归	os
侵	osax
束	mh
避	jhya
兄	jho
筑	zygq
厘	tky
休	om
摆	blyc
遭	vkka
户	qj
控	bawy
莫	vkm
迷	ra
童	ykyz
顿	ndtd
桌	ikm
绩	cud
虑	ine
爬	rj
瓶	wvtq
扩	bq
宜	ak
补	ai
颜	yipd
脱	fwj
恐	ygqe
伸	oki
执	bgq
末	bwx
镇	nbkw
套	mu
闹	dqd
毕	ifb
鸟	gt
罪	louu
枝	mbx
岛	gd
掌	pahb
湖	ejf
吹	hzw
编	cqjd
寻	sb
禁	mmyp
盖	wul
弱	gwgw
李	mn
犯	pgv
择	bxb
秋	pr
藏	vnzs
茶	vwm
伯	ok
摄	bkxx
默	lyrm
繁	zjwp
陈	snp
荷	voth
稳	pzse
诸	gyk
垂	itvy
尼	jfc
篇	zqjd
勇	cff
磁	jwcc
秘	pei
餐	izxc
刺	mdo
偏	oqjd
晨	ktyc
姓	xiu
胞	ffj
君	sih
鸡	xgt
亿	og
奶	xgv
狗	pfh
挂	byy
醒	jtku
厚	tkn
矿	jqv
菌	vhp
污	eyg
尔	zp
寒	avww
伙	or
斜	wmwb
堆	you
映	kdm
销	npf
奋	ml
仪	oqx
杯	mti
登	zthw
扬	bgo
袋	onqc
索	bacp
冰	wir
探	bawm
横	mvlw
溶	earh
忍	sqe
暴	kvwr
逃	ora
冬	xw
抓	br
献	bdwm
遗	lda
励	ttsf
哈	hwh
损	bhd
泪	ek
牙	sii
荣	vam
幕	vkmd
播	birl
词	gsth
聚	kxp
促	oho
借	ovk
偶	okdq
稍	ppf
航	fqg
订	gtv
博	bbqb
搬	bfgx
森	mmm
夺	mbz
菁	vuf
闪	dwc
隔	stht
享	qhn
抵	bfnq
潮	ebkf
碰	jwp
朵	gmz
载	bbn
宽	avdo
币	id
监	ozlz
灰	brc
纯	cnd
腿	fsca
辆	btdw
玻	uix
域	ynht
悲	ouue
淡	err
雄	bcou
抬	bch
阻	skv
乃	ggi
劲	cyf
核	mqcw
覆	jpzx
逼	thla
铜	ndth
佛	ogo
蒸	vsrr
鞋	vlyy
斤	zzt
胡	jf
震	rtyc
劣	pif
巧	ytgv
洞	edth
洁	eyh
拥	bfv
督	ipxk
丈	tx
劝	xf
貌	pko
麦	ux
愉	iwfo
购	dfc
售	ouhz
尊	wjtb
麻	qmm
彼	pix
阴	sf
湿	ekp
缩	caok
贸	fsd
插	bibf
颗	kmtd
智	zmhk
肥	fj
敬	vfhx
惜	ivk
龙	bfq
搞	bqhh
粒	ry
璃	uqxc
乏	ia
胶	fex
赏	pahd
松	mwc
粮	rqsc
壁	jhyy
迹	qpa
叔	ipx
频	optd
谋	gvm
尾	ju
磨	qmmj
皇	ku
猛	pnl
缘	cjp
鬼	lc
患	hhie
础	jddv
奏	mtm
奖	izm
哲	bzh
肤	fm
耐	tdb
轴	blv
偷	owfo
粗	rk
迅	gba
浮	ern
哩	hky
迟	jqa
爆	rkvr
羊	wux
佳	oyy
摸	bvkm
梦	mmz
幼	cf
侧	odo
凭	oiyg
泡	efj
碎	jqwb
盐	yil
废	qdxq
挑	bor
婆	eixx
岩	dj
泣	eyv
蒙	vatp
跌	jim
烦	rtdv
秒	ppi
俄	oibn
汗	eyv
煤	rvm
穷	awf
箱	zmk
绘	cwyc
兰	wy
仰	ofs
描	bvl
饰	zzd
残	tzn
版	zzxv
绕	cnto
尖	pm
讯	ggb
碗	jazg
盆	wsl
操	bhhm
氢	ucy
纵	cww
欲	rhzw
番	irl
嫂	xfix
腰	fjx
牌	zlb
肩	qjf
冒	dyk
幅	dthl
累	lcp
舒	wyhi
倾	oitd
奔	mbv
暂	bzk
豆	thw
壮	iy
擦	bazp
玉	uq
典	dvw
薄	vebb
滑	egf
详	gwu
页	tdx
皆	ifk
夹	mw
糖	rqbh
怜	iwa
梁	eswm
授	brax
征	ptov
捕	bbq
剩	piyo
邻	was
旋	qzso
凉	wqhp
盾	zbk
延	iog
械	mnv
码	jg
届	jl
恢	ibr
迫	ka
予	csi
召	sh
措	bvk
珠	ubw
琴	uuwa
妻	tbx
宋	am
陷	szf
俗	orh
弯	qpg
宇	atb
殖	tzbk
册	fft
瞧	kour
衡	pzly
塞	avwy
彻	pns
诚	gnf
钻	nih
壤	yqhc
妙	xpi
厅	tt
缓	cryx
闭	dbic
渡	eqvx
骂	hhg
旗	qzvw
宫	ahh
戴	blvn
析	mz
符	zob
暖	kryx
纳	cdw
蓝	vozl
阔	deij
漠	evkm
疗	qs
伴	owb
坡	yix
彷	pqv
截	boun
棒	mmb
仿	oq
犹	pnq
挺	biyg
艰	xsc
躺	iduh
役	pgx
悄	ipf
鼻	klto
乙	gg
竞	yjz
圣	xy
网	dxx
剪	wfos
灾	ar
藉	vbwk
障	sykb
割	abho
狂	pu
署	lyk
虎	ing
姿	wzwx
欣	zzwv
珍	uwp
猫	pvl
践	jn
跃	jimv
矛	csii
援	bryx
邦	bsv
弃	qcv
龄	owda
启	qjh
裂	tzoc
寄	amth
拖	bzv
贴	dihv
伍	ou
殊	tzbw
袖	al
纺	cq
柱	mqu
池	ev
申	ki
拜	utb
炸	rziy
脏	fqy
朗	qscf
贡	yd
俩	otdw
竹	zizi
虚	inp
辛	ybz
墨	lyry
辞	ijyb
伦	owf
怒	xxe
瓜	czcq
胸	ffxd
趋	yozs
填	ybkw
哦	hibn
牲	biu
卡	ii
唐	qbh
忆	ig
净	wzsi
踏	jirk
软	bzw
怨	zge
忧	inq
桩	mqy
滴	eedj
浓	eac
埋	yky
宁	at
扇	qjss
塑	wdfy
饮	zzw
驶	ghx
勉	zhof
晓	knto
渔	elv
碳	jdbr
兼	wsp
吓	htq
慰	jype
抢	bwg
审	akiz
捉	bho
绳	chl
饿	zibn
叙	wmx
估	oj
呈	hu
闷	de
泛	eia
祝	aj
贫	wsd
疾	qzm
厉	tts
胆	fkt
嘛	hqmm
摩	qmmb
陪	syh
寂	aipx
扑	biv
邀	kqxa
骑	gmth
辉	ptob
勤	vhuf
孤	nc
挤	bqo
谷	rh
帽	ddyk
蜂	lxb
涂	ewm
旦	ktz
秦	mp
串	hhi
呆	hmz
嗯	hhme
驾	fhg
咬	hex
毁	fygx
孙	npv
庆	qmc
削	pfo
拔	bbxq
帐	dnwv
伏	omv
惟	iou
眉	jk
辩	ybgb
抑	bfs
脉	fqsr
恰	iwh
灌	evhu
颇	ixtd
苍	vwg
拒	bss
棵	mkm
肚	fy
稻	prf
菲	vouu
汤	ego
疯	qgx
仗	otx
剥	siro
哎	hvx
牧	bxv
腐	qobw
悉	ire
壳	yag
炼	rnsw
剂	qoo
恨	isc
搭	bvwh
炉	rqj
秀	pg
签	zwe
绪	cyk
猪	pyk
闲	dmc
井	vyo
窝	awhw
撞	byky
匆	fx
宿	aotk
愤	ibvd
晶	kkk
滚	eecc
墙	yywh
昏	fnk
铅	ngh
甘	vvy
膀	feaq
违	bsa
忠	hie
戒	nv
浅	en
烂	rwy
猜	puf
扫	bs
沟	efc
润	edu
甜	ijv
耕	bwvv
迁	iba
狱	pgm
凝	wfzo
喷	hbvd
糊	rjf
吐	hy
姊	xigi
躲	idum
腾	fwmg
卷	wmg
罚	lgo
敲	qhdx
稀	pxbd
振	btyc
贯	jbd
疲	qix
筋	zff
尝	payc
瓦	tigq
慌	ivqp
漂	ejyp
裁	bqcn
赖	mhzd
欠	zw
漫	eklx
赚	dwsp
肃	bow
柴	ofm
赤	yp
焦	our
荒	vqp
丢	iyc
杆	my
盼	kws
臂	jhyf
臣	ssii
涉	eop
聪	kwhe
阅	dwj
叹	hxv
胎	fch
汇	es
租	pk
胀	fnw
膜	fvkm
仙	odv
吉	yh
刊	yov
冠	ayob
慧	bbse
缝	cxba
遵	wjta
丧	ywc
纤	cib
峰	dxb
柔	csim
澳	eidm
辈	ouub
驻	gqu
哀	qhc
弓	gsg
炮	rfj
茫	veq
幻	cs
箭	zwfo
膨	fyhp
薪	vymz
蜜	aeil
椅	mmth
稿	pqhh
杨	mgo
籍	zbwk
仁	oyv
丛	wwt
症	qto
碍	jktb
宾	aztw
撤	bqcx
醉	jtqb
乌	gtc
坦	ykt
揭	bkfd
敏	zjwx
泳	eqsr
齿	owd
辨	ybob
伊	osi
恩	hme
宙	alz
拾	bwh
篮	zozl
雷	rl
淀	eato
纱	cpi
融	thdl
岂	dsd
伪	oqfq
抛	bgf
肌	fg
刑	tvo
涌	ecf
傅	obqb
匀	fwc
奉	mbz
肺	ftd
悬	kce
耀	ptou
韩	bkbs
川	piii
瘦	qfix
盟	kfl
唤	hzdm
纹	cqv
尘	pyz
舍	wyh
厌	tmc
宅	ain
矩	zmss
隐	szse
鼠	fr
倘	opdh
冻	wnp
歇	kfww
燕	vhir
骤	gkxp
婶	xaki
缴	ckqx
铃	nwa
溜	efsl
皿	ldot
笼	zbfq
譬	jhyh
飘	jypx
潜	emmk
疏	soqp
祸	ahdw
胃	lfz
雾	rxf
脂	ffk
豪	qhap
贝	ddw
卵	fqsq
奴	xxv
恋	qpe
钉	nt
饱	zfj
卓	ikb
扰	bnq
返	zxa
库	qb
泰	mir
猎	pvk
紫	ofcp
耗	bwu
肠	fgo
铺	nbq
锋	nxb
碱	jnih
叠	xxxk
蚀	zlv
塔	yvwh
牵	mab
莲	vba
刷	jdo
廷	iyg
惨	icmp
锅	nhdw
敦	qhnx
添	etmp
蛇	laf
踪	jayp
崇	dayp
循	pzbk
梯	mwgi
瓷	wzwq
傲	oufx
捧	bmb
兽	wlth
漏	ejr
癌	qhhd
匹	so
芬	vws
魂	yclc
舌	ijz
洪	evw
眠	ksin
递	wgia
牺	bjv
玳	uon
瑁	udyk
邮	ls
骗	gqjd
丹	fqx
剑	weo
屈	jdd
托	binv
衫	apv
迈	tsa
锐	nwj
柜	mss
畜	qcl
鸣	hgt
丁	ttix
妖	xim
泼	edxq
奥	idrm
宪	abo
牢	abz
誉	ewuh
徐	pwm
掩	bml
涨	egnw
扎	bdv
妨	xqv
嫌	xwsp
溪	ercm
胁	ffw
挖	bawg
巾	ddi
挣	bzsi
皱	zsix
披	bix
拼	bwv
爽	mxxx
筒	zdth
抖	bwbv
扯	bov
拨	bdxq
鸦	siit
傻	ohxx
锦	nkd
塘	yqbh
岭	dwa
筹	zbb
赔	dyh
弧	gcv
寸	bbqx
愁	pre
株	mbwv
浸	esax
腔	fawy
览	ozdo
郊	exs
锁	npd
储	ogyk
吵	hpi
晋	tpk
偿	opac
恼	iqxd
扶	bm
滋	ewcc
痕	qscc
纽	csy
悠	oixe
睁	kzsi
嫁	xap
募	vkmf
吴	htm
扮	bws
沉	eag
漆	emwr
译	gxb
亏	yg
趁	yowp
喉	hosm
庙	qlc
巩	ygq
吞	tmh
熊	cffr
逢	xba
哼	hqhs
摘	bedj
矮	zmpx
砂	jpi
综	cayp
肢	fbx
舅	flf
艘	ffix
酬	jtep
奈	myp
炎	rr
锥	nou
倡	okk
仓	wg
侨	oimo
慈	wcce
戚	niip
晒	kj
脾	flb
隆	sxtu
允	co
掷	bwms
阁	dxh
黎	pfir
廉	qwsp
恒	itkt
橡	mzhp
裤	aqb
叛	wbzx
幽	dcc
纠	cii
翅	bxss
址	yov
挽	bzho
贤	oxd
轰	bxx
鹅	ibnt
伐	onv
嚷	hqhc
扣	bhv
欺	vwzw
洛	exh
硫	jqcp
络	cxh
遮	qvra
脊	rwf
庞	qbfq
呵	hth
翼	sslw
蓄	vqcl
衰	qhtc
贼	dnb
婴	ddxz
拆	bzq
沸	egov
辅	bbqv
挨	bczm
翁	wcss
萄	vfzd
葡	vfbq
袭	bfqc
辑	bhk
蒋	vizb
朴	mi
荡	vego
驼	gaf
狠	pscv
盒	whl
遂	wpa
雀	pou
倦	owmg
匠	sz
峡	dmw
滩	exou
询	gfk
栽	bmn
糟	rvkk
脆	fztg
轨	bgv
厦	ttkx
摔	bqcb
咐	hob
寿	bb
撒	bvfx
卧	siv
辽	sa
坑	yqg
尸	jsi
桶	mcf
蓬	vxba
雕	fyhu
勿	fo
鸭	kigt
懒	imhd
煮	ykr
狭	pmw
猿	pyhc
盗	wzwl
键	nbg
驱	gsx
晴	kuf
暑	kykz
疼	qxw
芦	vqj
烛	rlv
苗	vl
谊	gak
郎	qscs
钓	nfq
刘	qov
慎	ibkw
赴	yoi
隶	brx
魏	pxlc
堪	yvwd
斑	uqu
浑	eab
燥	rhhm
蔬	vsop
儒	ortd
抹	bbw
遥	rzba
慕	vkmp
枯	mj
杰	mr
昂	kfsz
兔	zhoq
斥	zqx
娃	xyy
嫩	xmhx
厨	tthb
拘	bfh
滥	eozl
滤	eine
凶	xd
桃	mor
瞎	kabh
魔	qmmc
俺	oml
惧	ikw
讥	ggv
颤	qhhd
仇	ogv
妥	rx
娱	xhtm
弦	gqc
铝	nhh
攀	mxxb
晃	kpto
秤	pyw
秩	pimv
腊	fvk
芽	vsii
郑	wms
陶	sfzd
刮	ijo
嘻	hyhh
罩	likb
臭	km
诊	gwp
宴	akx
挡	bps
肝	fyv
艇	fiyg
舰	fdo
亭	qhat
吨	hnd
岗	ddx
悟	iuh
蜡	lvk
泉	kir
浴	erh
溉	esco
钞	npi
扭	bsy
携	boug
姻	xhm
氛	uws
爵	rlsb
赢	qhfq
埃	yczm
毅	ypgx
渴	ekfd
浆	izir
狼	pqsc
猴	posm
罐	zbdu
贷	ond
雅	siiu
债	oud
咽	hhmv
喘	hdtd
昌	kk
炭	dbr
绑	cbs
葬	vtzv
董	vity
酷	jtbh
旨	fkz
栏	mwy
津	ebv
骆	gxh
恳	sce
亩	ql
诞	giog
遣	lha
鲁	lk
哇	hyy
碟	jvdm
纲	cdx
裹	qkmc
饼	zwv
骄	gimo
拳	wmb
摧	bdou
顽	yotd
悔	izjw
抚	btn
搅	beao
淋	emm
缠	cqky
胖	fwb
衬	abv
捷	btso
碧	ukj
羽	ssv
辟	jhyb
傍	oeaq
廊	qqss
悦	iwj
拟	biqw
柳	mfs
爹	wxzz
蕉	vour
蛙	lyy
夸	myg
辱	tycb
逗	thwa
乳	rnd
押	bki
轿	bimo
黏	pwih
玲	uwa
盲	qk
赌	dykv
跪	jztg
唉	hczm
夕	z
腹	fzkx
蚕	tml
裳	pahc
赠	dwlk
丑	sy
凑	wmtm
颈	cytd
侯	oszm
勒	vlf
媳	xke
掀	bzzw
柏	mkv
汪	euv
趟	yoph
蹲	jwjb
卑	lb
吩	hws
噢	hidm
喂	hltc
孕	gn
宵	apf
旱	kyz
曼	klx
挫	bwwy
旺	kuv
榜	meaq
氯	usir
逆	wda
皂	kn
膝	fmwr
吏	thx
碌	jsir
钩	nfc
勃	banf
堡	ohmy
寞	avkm
稼	pap
舱	fwg
誓	bzuh
劫	ycfv
啥	hwyh
惑	nhte
拢	bbfq
洒	ej
窄	awzy
隋	sbyf
霸	rvlf
俱	okw
圾	ygqv
枚	mxv
胚	ftit
跨	jmyg
霞	rjyx
伞	wwb
畅	kigo
歼	tzib
苹	vyw
驰	gvv
孟	nl
扔	bg
搁	bdxh
笨	zmt
茹	vxh
谅	gqhp
僧	owlk
茎	vcy
鉴	ozn
顷	itd
鳞	lrzb
哟	hcfq
蹈	jrf
丘	zt
侦	oid
勾	fc
垒	cccy
滨	eazw
聊	kfs
脖	fban
陌	stk
隙	spkp
哗	hofb
宦	asz
拱	bvw
昆	kif
御	pzts
掏	bfzd
梅	mzjw
疆	gytt
催	odou
寺	yb
祥	awu
纬	cbsv
肪	fqv
耻	ko
愚	kdie
惹	vbhe
摊	bxou
泌	eei
羞	wusy
蚁	lqx
谨	gvhu
邱	zts
饥	zg
佩	ogtd
巡	ca
吊	hdz
棍	mkif
棚	mff
歪	tito
畏	ltc
筝	zzsi
缚	cbqb
诱	gpg
辐	bthl
匙	ktof
壶	yap
寓	akdq
捏	bky
撑	bpab
玛	ug
吻	hfov
拦	bwy
渠	essm
焊	rky
灿	rd
萨	vsyi
券	wmsz
娶	kxx
慨	isco
拣	bnsw
槽	mvkk
氮	urrc
砍	jzw
谣	grzd
闯	dg
厮	tvwz
朱	bwx
瑞	udtd
盏	nlz
窃	awns
腺	fkir
郡	sihs
饲	zsth
乞	zgz
咳	hqcw
帕	dkv
汁	eb
泽	exb
芒	vqz
荃	vwu
驳	gxx
丙	tdw
兑	wjz
恭	vwp
拓	bjv
沃	eim
炕	rqg
耍	tdx
蝶	lvdm
桑	xxxm
瞪	kztw
蝇	lhl
詹	ztwh
冤	azhq
殷	zssx
渗	ecmp
帘	awd
糕	rwur
钠	ndw
歉	wspw
碑	jlb
鞭	vlox
鲸	lqhp
凳	zthg
咙	hbfq
巢	ckm
巷	vwj
抄	bpi
焰	rzf
盈	gxl
簧	zvlw
贪	wad
躯	idux
唔	huh
惩	ptoe
铸	nbb
幂	akmd
吼	hndv
娜	xsbs
扁	qjd
晰	kmz
趾	jov
锻	nzux
屡	jrx
拚	bcv
捞	bvaf
杜	myv
柄	mtdw
棋	mvw
殿	jvwx
凄	wtbx
竖	oxyz
侍	oyb
娇	ximo
搏	bbqb
浊	elv
笛	zl
莱	vtr
贩	dzx
媒	xvm
掘	bjdd
祭	zyp
谦	gwsp
踢	jkfo
陵	sywx
嗓	hxxm
堵	yyk
愧	ilc
竭	ykfd
贺	fhd
逸	zhoa
俯	oqob
凌	wywx
熄	rke
赋	dton
咧	htzo
哨	hpf
唇	tych
妄	qxz
姨	xmg
兹	wcc
逊	npa
啡	houu
撕	bvwz
泊	ekv
蔽	vrx
蚂	lg
迪	la
逝	bza
橘	mcsh
霜	rmk
侮	ozjw
呎	hjq
掠	bqhp
渺	ekpi
芳	vq
袁	yhc
裸	akm
醋	jtvk
刹	xmo
埔	ybq
尿	jir
熔	rarh
辫	ybcb
葵	vztm
蚊	lq
堤	ykto
惠	tkie
枕	mao
淘	efzd
溃	eld
颠	bkwd
麓	mmqf
姆	xjw
宰	ayb
寡	atks
煌	rku
磅	jeaq
禅	awkb
禹	ild
钙	nttg
鳍	lyfk
倚	omth
叉	xq
尉	jypb
晕	kab
玄	qcx
砖	jygq
蝴	ljf
谱	gwpk
乒	zti
宏	abc
框	msu
艳	bzj
蜢	lnl
裕	arhv
屁	jif
曝	kkvr
粪	rvw
莎	vepi
虾	ltq
呜	hgtv
崩	dff
澡	ehhm
烤	rytg
簿	zebb
锡	nkfo
乓	ztq
咸	nith
喻	hwfo
嘉	yhwh
妮	xjf
窑	awzd
绵	ckd
蝗	lku
涛	ebb
疫	qgxc
蜗	lhdw
袍	afj
裙	asih
凿	pwyd
仆	oi
啼	head
捐	bhf
箔	zek
肿	fhi
苇	vbs
蛮	qpl
诵	gcf
霉	rzjw
仟	oib
凯	dsig
咖	hfh
嘱	hjid
垫	bgqy
帆	dgq
庚	qsw
沾	eih
盯	kt
赐	dkfo
赵	yox
邪	siis
丫	wix
尧	nto
塌	ykss
歧	obx
粹	rqwb
踩	jrm
坊	yqv
垃	yyv
涯	etyy
淹	eml
秧	pdm
腕	fazg
谍	gvdm
赫	ypyp
链	nba
阀	don
骰	gfgx
雇	qjou
咕	hjv
屏	jwv
屑	jpf
甸	flc
矣	czm
耸	wwk
贾	jd
俘	orn
冶	wch
坟	yq
曹	vkk
澄	eztw
爪	rziq
耶	ks
舟	fifw
贱	dn
逛	pua
酱	izjt
嘲	hbkf
梳	mqcp
梨	pom
氨	uax
浩	ebh
藩	veil
豁	abhh
卅	vpt
憾	inie
渊	eor
舜	razb
艾	vx
馏	zfsl
驴	gqj
郁	bfsv
吋	hb
旬	fkc
梢	mpf
哄	hvw
嘿	hlyr
庸	qbf
杠	myv
渣	emkt
眨	kia
颂	wctd
仑	wf
捆	bhm
浇	ento
煎	wfor
狮	potd
碘	jdvw
衙	puhy
乖	ibif
孝	yn
怯	iycv
敞	pdhx
椎	mou
泄	evd
稚	pouv
讽	ggxv
鹰	qoot
佢	oss
咦	hmg
奢	myk
拌	bwb
敷	bqqx
榴	mfsl
芝	vaz
龟	zkd
僚	omkp
吾	uhz
崖	dtyy
拐	bhfv
郭	qhns
嗜	hyfk
嗡	hwcs
喽	hrx
墓	vkmy
屿	dtgt
厢	tmk
擅	bqht
朦	fvap
琳	umm
罕	awyz
膊	fbqb
蔼	vgkd
贮	dat
躁	jhhm
吟	hwa
喃	hbdy
帜	dhw
弥	gzp
煞	zsxr
猩	pkiu
瘾	qsze
筷	zisw
绸	cfyh
薯	vlyk
螺	llcp
贞	idx
逮	bra
骚	gxql
剖	yho
冈	dxc
桂	myy
焚	mmr
瓣	ybcb
竿	zy
绒	cnb
耽	kao
怖	ibd
缀	cxxx
奠	wjtm
寨	avwm
烁	rfp
瑰	ulc
祷	abb
酿	jtqc
颁	wstd
兆	orv
凸	itit
函	srd
咀	hkv
哑	htp
屯	ndx
忌	sde
挟	bmw
胧	fbfq
缅	ctl
聋	bfqk
鄙	hbhs
卸	ztos
埠	yihb
坛	yyc
契	bsm
奸	xyv
姚	xor
斩	bz
晌	kidh
朽	mtg
眯	krv
胳	fxh
茂	vni
襟	ammp
雌	oiou
绅	cki
莽	vmv
萝	vlz
袜	abw
迳	cya
鹿	qvif
吱	hbx
寇	ayox
捣	bgd
斧	wxz
沦	ewf
溢	ewwl
禽	wqxc
蒂	vead
蛛	lbw
僵	otlt
叭	hwv
呕	hsx
熬	ufxr
硕	jtd
磷	jrzb
吁	htb
粥	grg
缸	zbdy
茅	vcsi
萧	vbow
藻	vehm
辣	ybmh
陡	syo
履	jpzx
懊	iidm
捡	bwe
晤	kuh
枉	muv
澈	eqcx
窜	awhi
筐	zsu
妆	ixv
酵	jtyn
韦	bsx
兜	kfso
囊	thic
幢	dyky
毙	iftf
枢	msx
毯	urr
沫	ebw
羡	wuww
蔓	vklx
蝉	lwkb
觅	rdo
辰	tyc
迄	zga
骼	gfxh
丐	ttg
啪	hbk
媚	xjk
揉	bcsm
暇	kjyx
汰	emq
潭	ejkb
烫	egor
颖	fptd
肾	oxf
陋	stdd
叮	ht
坠	swy
惶	iku
曰	kht
洽	ewh
玫	uxv
绣	cpg
膏	qhaf
葫	vjf
锯	njj
阐	dwkb
俊	ocwx
凹	igdt
嚼	hrlb
屠	jyk
滔	erf
疤	qjc
瞒	kvtw
砌	jns
翔	wuss
肖	pf
莉	vpo
菩	vyh
邵	shs
锈	npg
凤	gxc
扳	bzx
拴	bwuv
挠	bnto
旷	kq
滞	evad
卜	iiq
袄	aim
嗅	hkm
囱	hxc
厕	tdo
昧	kbw
梭	mcwx
灶	ryv
聘	kltg
蟹	zfsl
饶	znto
丸	gqx
佣	ofv
僻	ojhb
叨	hsv
喧	hatt
帅	od
祈	az
纶	cwf
缔	cead
芭	vjz
葱	vfxe
蚣	lwc
蜈	lhtm
讶	gsii
谐	gifk
嗽	hmhw
夷	mgx
弛	gvv
恕	xhe
札	md
甫	bqx
虹	ly
袱	aom
褐	akfd
颊	mwtd
髦	upu
侈	ozz
吆	hc
喇	hmho
愕	ihhg
惭	ibz
扛	byv
擎	vfhb
搀	bzhw
昔	vk
橙	mztw
汹	exd
熙	sihr
穴	aw
翘	ntos
膳	fwuh
蜘	lzmh
蠢	mkll
辖	babh
韧	bssq
劈	jhys
哏	hsc
墩	yqhx
寮	amkp
昼	jqkt
炒	rpi
疮	qwg
绷	cffv
豫	csip
酌	jtfq
醇	jtqn
锄	nkf
隧	swpa
韵	ykfw
巫	yww
廓	qqhs
浙	ebzv
涤	exm
阮	syov
棕	mayp
淑	eipx
甩	fd
痒	qwu
瞬	krab
礁	jour
稠	pfyh
篡	zkmc
簇	zqzm
膛	fpay
讼	gwc
躬	idug
钝	nnd
佑	obh
囚	hwc
腻	fnyd
葛	vkfd
蚓	lgi
蚯	lzt
舆	zybw
辜	jyb
闺	dyy
伺	osth
坝	ydv
徊	phh
徘	pouu
档	mps
烘	rvwv
痴	qzmh
肆	ub
髓	gfba
厥	twdw
嗣	hdsh
噪	hhhm
啰	hlz
愣	ilq
拯	bsrt
榕	marh
琐	upd
畔	lwb
菱	vywx
逞	hua
鼎	kzz
俞	wfoz
俭	owe
卒	qwwb
嗨	hezw
尬	nwo
尴	nozl
枫	mgx
灼	rfq
矫	zmio
萌	vkf
衷	qhic
踱	jqvx
俾	olb
呐	hdw
噜	hlk
垮	ymyg
屉	jvd
弊	rxv
恤	iil
拇	bjw
栖	mjv
敛	wex
沛	etd
漾	ewur
珊	ufft
眶	ksu
硝	jpfv
秃	pgz
缕	crx
虐	inst
谬	gssp
鸿	eygt
唾	hity
墟	yinp
壕	yqhp
婉	xazg
岔	wsdz
巍	dpxc
忱	iao
扒	bwv
桨	izmz
沼	esh
澜	edml
蔑	vlnq
荐	vbin
虞	inhm
诀	gsw
衔	pny
骡	glcp
魄	klc
剿	ckmo
哧	hyp
嗦	hbap
嘶	hvwz
垄	bfqy
拏	xxb
炊	rzw
蟀	lqcb
蟋	lire
蹄	jead
镑	neaq
靴	vlof
峻	dcwx
崎	dmth
撰	bjjw
钦	nzw
涡	ehdw
溅	edn
炀	rgo
藤	vfwr
虏	inf
豹	pfq
蹦	jdff
逻	lza
锤	nity
铲	nyi
闸	dki
卉	bv
徽	pdtx
烹	qhsr
苟	vfhz
褂	ayyi
趴	jw
轧	bdv
陕	smw
倩	ouf
匈	fxd
撼	bnie
淤	eqww
珑	ubfq
笃	zgz
绢	chf
荫	vsf
蠕	lrtd
赃	dqy
鳃	lle
鸥	sxgt
墅	kycy
妞	xsy
宠	abfq
懈	izfb
拂	bgov
撮	bkkx
犬	mmq
琅	uqsc
瞄	kvl
磕	jycl
砾	jfp
稽	pnqk
窟	awjd
糙	rbha
肇	qjxb
舵	faf
荔	vfff
谎	gvqp
酥	jtp
镁	nwum
鹃	hfgt
咒	hhgz
抒	bcsi
榨	mawy
汞	yir
淫	eriy
甥	iulf
瞳	kyky
砸	jsd
篷	zxba
絮	xhcp
舶	fk
诬	gyww
钮	nsy
雯	rq
馒	zklx
姜	wux
崭	dbz
拭	bny
栅	mfft
潺	ejnn
狐	pcv
盔	brlz
矶	jgv
窒	awty
粘	rih
翰	bkbs
蹬	jztw
侣	ohh
啤	hlb
啸	hbow
垦	scy
奕	qpm
惰	ibyf
慷	iqbr
揪	bpr
搓	bwuy
挚	bgqb
拧	bat
棺	mah
炽	rhw
犁	pob
翌	ssy
蔡	vzyp
诈	gziy
贬	dia
辗	bjvc
霎	ryx
黝	lyrf
仕	oyv
呻	hki
哆	hzz
唆	hcwx
啃	hof
帖	dih
彰	ykbp
揶	bks
暮	vkmk
杖	mtx
杭	mqg
梗	mtkx
樟	mykb
澎	eyhp
禀	qhhp
菊	vfr
钳	nvv
镶	nqhc
颓	pgtd
冥	ake
嘘	hinp
屹	dzg
嵌	dvzw
歹	tz
狄	prv
瞻	kzth
禄	asir
穗	ptke
萤	val
跋	jbxq
钾	nki
锌	nyb
钥	nfv
锣	nlz
鞠	vlfr
骸	gfqw
鲤	lky
兢	jojo
刨	fjo
宛	azg
岳	ztd
柯	mthv
涩	esqo
焉	totr
瑚	ujf
瞥	rxk
碾	jjvc
稣	lp
蔗	vqvr
谜	gra
谴	glha
钜	nss
仲	ohi
匾	sqjd
卿	fscs
哺	hbq
坯	ytit
妒	xqj
婿	xsof
庶	qvr
怡	ich
悼	iikb
抉	bsw
撇	brxv
檐	mzth
溺	egww
炯	rdh
缎	czux
腥	fkiu
茸	vkz
诧	gain
讳	gbs
侥	onto
刃	sqx
孜	nx
岖	dsx
怠	che
悴	iqwb
憔	iour
攘	bqhc
曳	kfx
楞	mlq
狸	pky
甄	jytq
甭	tif
祀	ajv
粱	eswr
粤	hrtg
缤	cazw
肋	ffv
跛	jixv
逾	wfoa
颔	wahd
驮	gmv
魁	lcwb
鹊	vkgt
咚	hxwv
咪	hr
唰	hjdo
孵	fqsn
峦	qpd
搂	brx
泻	eatt
烙	rxh
穆	pkpp
肘	fb
蔚	vjyb
蛾	libn
饵	zk
黯	lyrk
倔	ojdd
呸	htit
啾	hpr
擒	bwqc
杏	mhz
橄	mskx
榄	mozo
殉	tzfk
殴	sxgx
毡	uih
瀑	ekvr
烽	rxb
瞅	kpr
洼	eyy
篆	zjp
腮	fle
诣	gfkv
镰	nqwp
冯	wgv
兀	tox
乔	imo
敝	rxv
汝	exv
涕	ewgi
溯	ewdf
潘	eirl
濒	eopd
瑙	uchx
睹	kykv
睑	kwe
窘	awsh
篱	zqxc
缉	chk
胺	fax
蕴	vckl
邓	xs
驯	gpv
斋	qtd
伶	owa
勘	vwdf
惘	idwq
揩	bifk
撩	bmkp
斟	vwdb
氓	qsn
沽	ejv
沥	etf
癖	qjhb
禾	pim
窿	awsu
簸	zvwx
苛	vth
蕃	virl
褶	assk
诡	gztg
踞	jjjv
踊	jcf
钴	nj
冉	dy
勋	hdf
咯	hxh
坞	ygt
寝	aisx
怔	ito
惦	iqih
欸	czmw
莹	vauq
瘪	qkwf
磺	jvlw
祂	av
箕	zvw
簌	zmhw
胰	fmg
蕾	vrl
镀	nqvx
锵	nizb
佐	oby
偎	oltc
凛	wqhp
剔	kfoo
啄	hpq
嘟	hyks
惕	ikfo
悯	idq
揽	bozo
橱	mttb
狈	pd
琢	upq
瘫	qxou
眺	kor
筵	ziog
聆	kwa
脯	fbq
茁	vdd
蘸	vjtr
蜒	liog
躇	jvyk
踌	jbb
迸	wva
铭	nzh
靶	vlj
肮	fqgv
偕	oifk
卦	yyi
吠	hmv
哮	hyn
呛	hwg
峭	dpf
帛	kd
恍	ipto
捎	bpf
昭	ksh
柬	mlx
榻	mkss
檀	mqht
檬	mvap
柠	mat
炬	rss
烬	rjqw
砝	jycv
脓	fac
茄	vfh
蜓	liyg
蜿	lazg
蜻	luf
诏	gsh
豺	pbi
贻	dch
酮	jtdh
霍	rou
馨	yjgk
鳄	lhhg
侠	omw
啻	eadh
堕	sbfy
憎	iwlk
抨	byw
棠	pahm
枣	mdw
淆	exbf
湃	eutb
熏	itlr
犀	jirb
畴	lbb
棱	mywx
窥	awmo
笆	zjz
绊	cwb
绎	cxb
荆	vtvo
虔	inqc
谕	gwfo
豌	thwg
账	dnw
雁	toou
亥	qcw
匿	svbh
吭	hqg
咆	hfj
呱	hcv
坎	yzw
妃	xsd
婪	mmx
彭	yhwp
扼	btg
拙	bdd
揣	bdtd
杉	mpv
椭	msbf
沐	em
泞	eat
潇	evbw
泸	eijv
琉	uqcp
砰	jyw
窦	awym
芜	vtn
蚩	dtl
蜀	lfl
谭	gjkb
饷	zidh
驿	gxbv
鲍	lfj
佃	ol
俸	omb
嘀	hedj
坪	yyw
垛	ygm
孽	vihn
徙	poo
怦	iyw
擂	brl
晾	kqhp
毋	jbx
淌	epdh
沧	ewg
瀚	ebks
炫	rqc
瑟	uuei
眷	wmk
筛	zotd
紊	qcp
苞	vfj
谆	gqhn
咨	wzwh
迂	tba
锭	nato
雏	zsou
驹	gfh
俟	oczm
叩	hs
吕	hhz
嚣	hhth
壹	yatw
娥	xibn
嬉	xyhh
庇	qif
挎	bmyg
捻	bwae
泵	jirz
涵	esrd
牡	byv
狞	pat
瘤	qfsl
矗	bkbk
秽	pdz
茧	vlz
菇	vxj
咏	hqsr
谏	gml
赎	dywm
遏	kfwa
酋	wjt
铀	nlv
隘	swwl
鸽	whgt
俨	otpi
刿	dzo
勺	fq
咋	hziy
喔	hjty
啧	hud
嘈	hvkk
奎	myyz
孢	nfj
恬	iij
惴	idtd
憋	rxe
揍	bmtm
枷	mfh
栗	jm
汲	egq
湘	emk
涧	edk
痰	qrr
眩	kqc
瞌	kycl
绞	cex
苔	vch
蛀	lqu
钧	nfw
雍	qcou
颚	hhyd
馁	zrx
馋	zzhw
丞	srt
冕	dyzo
嚓	hazp
悍	iky
怅	inw
搔	bxql
攒	bbod
桅	mztg
椰	mks
淮	eou
猖	pkk
疙	qzg
绰	cikb
芯	ve
魅	lcbw
叽	hgv
噬	hzyw
峙	dyb
彬	mmp
懦	irtd
揄	bwfo
撬	buuu
栩	mssv
桀	zbm
梧	muh
浦	ebq
淳	eqhn
溴	ekm
瘩	qvwh
磋	jwuy
缄	cnih
缆	cozo
茵	vhm
萎	vpx
蚜	lsii
蜥	lmz
跺	jgm
迭	ima
骇	gqcw
俐	opo
凰	gku
咂	hsd
唧	hscs
哽	htkx
呗	hdv
喀	haxh
圳	ypv
嫉	xqzm
屎	jr
帚	sad
惋	iazg
捂	buh
斐	ouuq
晦	kzjw
梆	mbs
椒	mipx
槐	mlc
樵	mour
槛	mozl
熨	jypr
狩	pab
猾	pgf
疚	qzq
硅	jyy
祠	asth
窖	awbh
绚	cfk
谒	gkfd
踝	jkm
嘅	hsco
嘢	hkyi
咁	hv
啱	hdj
喺	hoip
咗	hby
锢	nhj
隅	skdq
霹	rjhb
缰	ctlt
鹑	qhnt
鹌	mlgt
冗	ag
删	ffto
匣	ski
哉	bhn
喁	hkdq
噗	hpwm
奄	mlz
妓	xbx
姥	xyf
崛	djdd
恃	iyb
憬	ikqp
惫	xle
戎	nbc
捍	bkyv
棘	mdmd
氟	ugo
漓	eqxc
烷	rayo
狡	pex
痼	qhj
绥	crxv
绶	crax
绉	czs
翡	ouus
耙	bwj
蝠	lthl
蝙	lqjd
褪	asca
赁	oiyd
锰	nnl
钨	ngt
鲫	lscs
俏	opf
傀	olc
儡	olll
喳	hmkt
媾	xvdy
峨	dibn
巅	dbkd
彪	ingp
悸	ipn
挪	bsbs
捶	bity
桐	mdth
榆	mwfo
甬	cfx
矢	zm
箫	zbow
耿	kr
肛	fyv
舔	ijtp
舷	fqc
荚	vmw
蒲	vebq
蒜	vypp
藕	vbwq
衍	pey
裔	qcdh
贿	dbf
蹂	jcsm
躏	jvdu
陛	sify
雹	rfjz
雳	rtf
靡	qmmu
饪	ziyv
凫	ggc
伎	obxv
凋	wfyh
嗒	hvwh
嘧	haed
堰	yskx
憧	iyky
揖	bhkv
殃	tzdm
汛	egb
沌	end
淞	emwc
炙	zr
焕	rzdm
熹	yhwr
痊	qwuc
盹	knd
睫	ktso
硌	jxhv
砚	jdov
禧	ayhh
舀	rf
蜴	lkfo
褛	arx
褴	aozl
诛	gbw
赈	dtyc
蹋	jkss
锑	nwgi
铛	nps
陨	shd
飕	gxfx
鹏	ffgt
乍	ziy
咎	xih
唬	hing
垣	ytkt
垢	yzth
妾	yxz
侄	otcy
娼	xkk
崽	dle
弗	go
徇	pfk
戮	sswn
戳	sson
斓	qdml
烯	rxbd
疋	sox
痹	qlto
竽	ztb
笋	zsiz
粜	ddr
绽	cato
臀	jvwf
蓉	varh
诫	gnv
诲	gzjw
辍	bxxx
酣	jtvv
酯	jtfk
锹	npr
陇	sbfq
馑	zvhu
骏	gcwx
鬃	upap
佬	oyf
倭	opx
叼	hst
噩	uhhh
寥	assp
拄	bqu
抿	bsin
撺	bawi
樱	mddx
湍	edtd
瓢	jypc
痪	qzdm
瘠	qrwf
祯	aid
箩	zlz
蕊	veee
薛	vihb
薰	vitr
踉	jqsc
跄	jwg
蹭	jwlk
遽	inpa
衅	ilwb
镍	nkm
顸	ytdv
馅	zzf
鹄	bhgt
僭	osok
匡	su
呃	htgv
吮	hco
嗳	hrax
囡	hxc
坳	ycfv
壑	iaty
嫦	xpad
惚	ifoe
拗	bcfv
拎	bwa
掣	bdob
搪	bqbh
撅	btww
柑	mv
桓	mtkt
梵	mmgq
栈	mnv
桠	mtp
槌	miha
桦	mofb
滓	eayb
渍	eud
澹	ezth
狰	pzsi
瞰	kskx
秆	pyv
筲	zpf
籽	rn
荀	vfk
菠	veix
蛹	lcf
诅	gk
赘	ufxd
闽	dl
鞑	vlma
驭	gxv
骧	gqhc
鲧	licp
冽	wtzo
嘤	hddx
圃	hbqc
姬	xsii
惆	ifyh
扈	qjhj
摒	bjwv
撂	blxh
朕	fwm
梓	myb
沮	ekv
淦	env
熠	rssk
畸	lmth
疡	qgo
皓	kbh
皑	kdsd
睦	kywy
秉	psx
穹	awgz
窠	awkm
篙	zqhh
粟	jrz
糠	rqbr
纥	czg
缨	cddx
翟	ssou
翩	qjds
耘	bwyc
膺	qoof
臼	fzts
荤	vab
蛤	lwh
猬	plf
蟆	lvkm
蛰	bgql
蝎	lkfd
襄	qhhc
辊	bkif
铡	ndo
镊	nkxx
鞍	vlax
颟	vtdd
鲨	epil
鳗	lklx
唷	hqcf
嘎	htkn
唠	hvaf
嘹	hmkp
嚏	hbao
囔	hthc
圩	ytbv
嫔	xazw
寰	altc
峒	ddth
岚	dgx
徨	pku
忿	wse
掸	bwkb
撵	bmmb
橹	mlk
浞	ehov
煦	kfhr
煽	rqjs
牍	zywm
牟	cb
琪	uvw
瑜	uwfo
祟	ddyp
笠	zyz
绯	couu
缣	cwsp
羔	wur
翱	kmbs
聂	kxxz
芥	vwo
蚪	lwbv
蛆	lkv
蝌	lpwb
蝈	lhuq
蚝	lu
讪	gdv
跚	jfft
蹒	jvtw
轭	btgv
迦	fha
邃	awwa
铿	noxy
饺	zex
鬓	upaw
鹂	tdqt
匕	fid
吝	qh
喏	hvbh
唢	hpd
婢	xlb
宕	ajz
岌	dgqz
幌	dkpo
庵	qml
彤	fqp
恣	wzwe
怂	wwe
惮	iwkb
拽	bkf
掐	bzf
掰	uwsb
撷	byhd
旭	gkc
暨	scst
柿	mqd
楝	mml
湄	ejk
獗	ptww
琵	uuif
琶	uuj
瑶	urzd
瓮	wctq
痘	qthw
疟	qst
皖	kayo
卢	ij
碉	jfyh
筏	zon
箍	zbsd
萦	vacp
胯	fmyg
臊	fhhm
芋	vtb
茬	vbiy
莠	vpg
萍	veyw
薇	vpdx
藓	vlwu
蛟	lex
蛔	lhh
螟	lake
褥	atyb
谤	geaq
赦	ypx
踵	jity
遐	jysa
铮	nzsi
陀	saf
亨	qhs
吒	hin
喋	hvdm
噤	hmmp
咛	hat
埂	ytkx
塾	qhny
峪	drh
弘	gc
恿	cfe
憨	skxe
戈	nnqx
戾	qjm
拷	bytg
捱	btyy
捺	bmyp
栓	mwuv
湛	evwd
燧	rwpa
畿	ccnl
睬	krm
瞟	kjyp
磊	jjj
矾	jgq
缭	cmkp
羚	wuwa
羹	wurm
翎	wass
耷	mkz
胫	fcy
腑	fqob
舛	zbv
苯	vmt
藐	vpko
蜕	lwj
讣	giv
谚	gyip
蹙	niio
邑	hjz
酪	jtxh
铐	nytg
镂	nrx
闾	dhh
阱	sv
霄	rpf
霓	rfo
靖	yuf
蓦	vkmg
髻	upyh
卤	ihx
黍	pwir
兮	wgz
冼	wbov
刁	stc
啜	hxxx
唛	hux
噘	htww
哒	hma
巳	jsdx
恁	oiye
戊	ni
拈	bih
捋	brb
抡	bwfv
掂	bqih
揾	bkl
攥	bzkp
朔	wdf
榷	maou
毗	lif
沏	ens
漱	emhw
涟	eba
漉	eqvf
荧	var
爿	zdit
犊	bywm
狙	pkv
瑕	ujyx
疵	qof
癞	qmhd
皙	mzk
睾	ilyy
磡	jvwf
祺	avw
秸	pyh
篾	zlnq
钵	nmt
羲	wupn
胱	fpto
臻	tcyp
芍	vfq
讹	gof
豚	fpv
趵	jfq
轩	byv
轶	bim
逵	ywya
酚	jtws
醺	jtir
铎	nxbv
镬	nvox
阖	dycl
靓	ufdo
靼	vlkt
饯	zn
黐	pwic
龇	owdf
亟	shxt
伉	oqg
佰	otk
倌	oah
偻	orx
俪	otdq
叱	hfv
咿	hosi
唁	huhv
悖	iban
怆	iwg
憩	ijke
拮	byh
擤	bklo
曙	klyk
杈	mxq
柩	mszq
桉	max
沓	irk
淇	evwv
渌	esir
渲	eatt
滇	ebkw
漪	epmh
沪	eqj
潦	emkp
疹	qwp
矜	csia
糜	qmmr
绮	cmth
缈	ckpi
缥	cjyp
腆	fdvw
腌	fml
脍	fwyc
蔷	vywh
蚱	lziy
袒	akt
裘	brqc
裱	auc
诽	gouu
跷	jnto
辕	byhc
辘	bqvf
遨	ufxa
酝	jtyc
铢	nbw
铬	nxh
铨	nwu
镫	nztw
镭	nrl
镯	nlfl
腼	ftl
颅	ijtd
肴	xbf
莺	vagt
鹤	aout
麟	qvib
亘	tkt
仄	tw
佯	owu
侃	ohp
佼	oex
傩	oxou
嗖	hfix
坍	yfq
夭	imx
娓	xju
媲	xhwf
孺	nrtd
寐	azbw
幔	dklx
弭	gkv
彦	yip
徭	przd
忖	ibv
恙	wue
戌	nit
捅	bcf
掖	bqoq
掇	bxxx
搐	bqcl
擘	jhyb
攫	bkkx
桷	mzf
渤	ebaf
渝	ewfo
琦	umth
痉	qcy
盅	hil
睿	iatk
稞	pkm
窍	awyg
竺	zyz
纫	csq
缪	cssp
缮	cwuh
羁	lvlg
芸	vyc
莒	vhhz
萃	vqwb
蒿	vqhh
蓓	voyh
虱	gil
蛞	lijv
蜷	lwmg
蝓	lwfo
螃	leaq
裨	alb
赊	dwyp
踮	jqih
蹶	jtww
辙	bqcx
酗	jtxd
锱	ncl
锚	nvl
镘	nklx
鞘	vlpf
颉	yhtd
饬	zzfv
骒	gkmv
髭	upof
亢	qg
佚	oim
倏	oixm
剃	wgio
咻	hom
啐	hqwb
喙	hjp
噎	hyaw
噙	hwqc
嚎	hqhp
垠	ysc
堑	bzy
壅	qcoy
峥	dzsi
嶙	drzb
嵘	dvam
彗	bbs
恸	iycf
懑	evte
慑	ikxx
扉	qjou
暧	krax
棣	mbr
楷	mifk
榈	mdhh
氦	uqcw
氾	eg
泯	esin
涎	eiog
浒	egzb
炖	rndv
炳	rtdw
炷	rqu
燎	rmkp
琛	uawm
畦	lyyv
瘟	qkl
痨	qvaf
盂	tbl
眈	kaov
纣	cbv
耆	yfk
耜	bwhv
胤	ocfv
腴	ffwv
臃	fqcu
茴	vhh
蚌	lbv
蛐	lhv
蜇	bzl
褒	qohc
贰	nyd
赂	dxhv
蹊	jrcm
迢	sha
遁	zbka
遛	fsla
邝	qsv
铆	nfs
銮	qpnz
阂	dqcw
阎	dzf
霾	rpky
霭	rgkd
驸	gob
骈	gwv
鳔	ljyp
鸵	gtaf
鹉	tont
鹜	csit
鹦	ddxt
伛	osx
僮	oyky
刽	wyco
匍	fbqc
匐	fthl
卯	fs
啖	hrr
嗟	hwuy
嗤	hdtl
嗝	htht
冢	apq
夙	gtz
妍	xtv
姗	xfft
嫡	xedj
妩	xtn
娴	xdm
孀	xrmk
孑	nstx
岐	dbx
岬	dkiv
忡	ihi
怵	imq
懵	ivlk
擞	brxx
杳	mkz
锨	nzzw
柞	mziy
柁	maf
楫	mhk
椿	mmkv
殆	tzch
殒	tzhd
氤	uhm
氲	ukl
涅	eky
涸	ehj
渭	elf
湎	etl
珀	ukv
琥	uing
瘿	qddx
皎	kex
盎	dmlz
瞩	kjid
碴	jmkt
稷	plwx
笺	znz
篓	zrxz
绺	cxih
缯	cwlk
纂	zkmp
罅	zbdb
羿	ssv
胛	fki
臾	fwx
荼	vwmz
荞	vimo
螂	lqss
螅	lke
褓	aohm
觑	inpo
诘	gyh
诙	gbr
踅	bzho
踹	jdtd
蹇	avwo
蹚	jpay
蹩	rxho
辄	bkd
铰	nex
铠	ndsd
镗	npay
隍	sku
韶	yksh
颌	whtd
馈	zld
髯	updy
鳅	lpr
鳀	lkto
鸠	ggt
伫	oat
倪	ofo
偃	oskx
剐	hdwo
叵	shc
呶	hxx
咫	jqhw
呲	hofv
唏	hxbd
啷	hqss
嗔	hbkw
嘁	hnip
嚅	hrtd
嗫	hkxx
囤	hndc
圭	yy
奚	rcm
妊	xiy
娟	xhf
嬷	xqmc
孪	qpn
崔	dou
嵩	dqhh
巯	cyqp
弩	xxg
悒	ihj
惺	ikiu
忾	iuv
搽	bvwm
抠	bsxv
揿	bnzw
掳	binf
攸	oix
杷	mjv
枇	mif
樊	mxxm
橇	muuu
毖	ifei
汐	ezv
泱	edm
淙	eayp
浏	eqov
猝	pqwb
猢	pjf
狲	pnp
痞	qtih
瘁	qqwb
疱	qfj
眸	kcb
砧	jih
碜	jcmp
祉	ao
笸	zsh
纭	cyc
胭	fhmv
膘	fjyp
舐	ijfn
舢	fdv
芟	vgx
茉	vbw
苒	vdy
茭	vex
葚	vvwd
莅	voy
蕨	vtww
蜉	lrn
蝣	lqzn
蝼	lrx
蛊	ll
衮	ecc
讷	gdw
谛	gead
谙	gykv
谪	gedj
躅	jlfl
踯	jwms
蹑	jkxx
迥	dha
邸	fnqs
醣	jtqh
醛	jtvu
釉	irlv
铂	nk
铧	nofb
雩	ryg
颏	qcwd
飒	ygx
飨	cwqc
鸯	dmgt
鸳	zggt
黔	lyra
鼾	klty
龋	owdd
俣	ohtm
冀	iyfw
匝	sdc
咩	hwu
啬	ywhh
嗑	hycl
嗷	hufx
嚄	hvox
呓	hvg
囫	hfoc
囿	hbf
囵	hwf
坤	yki
垩	tpy
娄	rxz
婷	xqht
妪	xsx
嫣	xtor
孳	wccn
孱	jnnn
廒	qufx
悻	iywy
惬	ismw
恻	ido
恹	itm
扪	bdv
昵	kjf
昙	kyc
杵	mzb
桎	mtcy
楠	mbdy
楣	mjk
榛	mmpv
槎	mwuy
殡	tzaw
氅	pdhu
沁	ee
泅	ehw
涔	edwa
灸	zqr
猥	pltc
犷	pq
獭	pmhd
猡	plz
痢	qpo
瘴	qykb
疖	qsc
癫	qbkd
砷	jki
砥	jfnq
笙	ziu
籁	zmhd
绌	cdd
缫	cckm
罄	yjgd
舫	fqv
艄	fpf
芹	vz
苎	vat
莓	vzjw
蛄	lj
蟑	lykb
蟒	lvmv
亵	qbgc
裆	aps
诋	gfnq
诿	gpx
谄	gzf
谀	gfw
赡	dzth
趄	yok
迤	zva
逍	pfa
迩	zpa
钐	npv
钛	nmq
钼	nkv
镏	nfsl
镖	njyp
饨	znd
馄	zkif
馍	zvkm
鬣	upcr
鹞	rzbt
鹬	csit
龊	owdo
龌	owdy
龛	whbq
仃	ot
仨	ouv
侉	omyg
偌	ovbh
剌	mho
劾	qcwf
呷	hkiv
噫	hyke
夯	mfz
奂	zdm
妁	xfq
妠	xdw
娩	xzho
孰	qhnq
峋	dfk
帷	douv
帧	didv
庐	qqj
忸	isy
忪	iwc
忤	izbv
怩	ijf
悚	imh
悌	iwgi
懿	yate
戟	bkbn
掼	bjbd
摹	vkmb
擢	bssu
挛	qpb
曦	kwun
杓	mfq
楔	mbsm
椽	mjp
枞	mww
槟	mazw
棂	msr
毬	ubrq
沱	eaf
涓	ehf
淬	eqwb
涣	ezdm
湫	epr
滂	eeaq
漩	eqzo
涝	evaf
濡	ertd
爻	xxz
獐	pykb
獠	pmkp
璨	uizr
璐	ujxh
璧	jhyq
琼	uqhp
瓤	qhhc
瘌	qmho
瘊	qosm
祁	asv
秫	pmq
窣	awqb
窸	awie
笤	zshz
筮	zyww
箸	zyk
粕	rkv
粼	rzbc
翕	whss
胥	sof
腋	fqoq
腓	fouu
脐	fqo
臧	nzs
芙	vmz
苜	vkz
茗	vzh
苌	vnw
萼	vhhg
莴	vhdw
蓖	vhxf
蓿	vaok
蘑	vqmj
蟠	lirl
衾	waqc
裰	axxx
褡	avwh
谧	geil
诌	gzs
谗	gzhw
赳	yoii
趿	jgqv
跤	jex
踟	jzmh
蹰	jttb
辎	bcl
辏	bmtm
邹	zss
邬	gts
醚	jtra
铵	nax
镐	nqhh
鏖	qvin
镣	nmkp
闵	dq
阑	dmlc
闱	dbs
阪	szx
雉	zmou
鞅	vldm
颐	sihd
颦	optb
骁	gnto
魆	lcni
鲛	lexv
鲑	lyyv
鸹	ijgt
鸾	qpgt
麋	qvir
黜	lyrd
黛	onlr
俚	oky
伧	owg
侩	owyc
儆	ovfx
胄	lfz
剜	azgo
卺	srtg
厄	tg
厝	tvk
咄	hdd
咭	hyh
啁	hfyh
嗥	hkmb
嗲	hwxz
噌	hwlk
噶	hvkd
哜	hqo
囹	hwax
圄	huhc
圉	hywy
垸	yayo
埸	ykfo
坜	ytf
壬	iyx
夼	mpz
奘	zym
妣	xif
娑	epix
娠	xtyc
袅	gqcc
婵	xwkb
娆	xnto
屐	jpbx
嶂	dykb
幡	dirl
廖	qssp
廪	qqhp
彀	yatx
忑	tqe
忐	ie
愠	ikl
慵	iqbf
怄	isx
忏	iib
戡	vwdn
拊	bob
抻	bkiv
掬	bfr
捩	bqjm
捭	blb
掮	bqjf
搠	bwdf
搡	bxxm
挞	bma
敉	rxv
敕	mhx
斡	bkbb
斫	jzv
旯	kg
旮	gkz
晢	bzk
杼	mcsi
柚	mlv
桔	myh
楂	mmkt
榭	midb
樽	mwjb
桧	mwyc
檩	mqhp
栎	mfp
橥	pykm
欷	xbdw
殚	tzwb
殓	tzwe
氡	uxw
氰	uuf
汀	et
汨	ekv
汾	ews
泔	evv
洌	etzo
洄	ehh
浚	ecwx
涿	epq
滕	fwmr
潢	evlw
濯	essu
烊	rwu
焖	rde
牝	bfv
犄	bmth
狒	pgo
珞	uxh
瑗	uryx
町	lt
疝	qdc
疳	qv
瘢	qfgx
癣	qlwu
睐	ktr
睨	kfov
睽	kztm
瞑	kake
硼	jff
礴	jveb
穑	pywh
竣	ycwx
箴	znih
篝	zvdy
簪	zsok
篑	zldz
纰	cif
绫	cywx
缜	cbkw
罔	dwq
翳	szms
肄	fzmb
肫	fnd
腱	fbg
膦	frzb
臆	fyke
臜	fbod
刍	zs
茱	vbwz
葩	vkj
葳	vnix
蓐	vtyb
蕈	vjkb
蕞	vkkx
荟	vwyc
蚤	xql
蛉	lwa
蜃	tycl
蝥	csil
衩	axq
衽	aiy
褊	aqjd
觐	vhuo
讫	gzg
诃	gth
诩	gss
诮	gpf
诤	gzsi
诹	gkx
谑	gint
誊	wmuh
豢	wmp
貂	psh
赅	dqcw
赣	ykbd
趑	yoww
趱	yobd
跎	jafv
跶	jma
跻	jqo
蹿	jawi
轼	bnyv
辚	brzb
轳	bijv
迓	siia
迨	cha
逡	cwxa
遴	rzba
邂	zfsa
逦	tdqa
鄱	irls
钗	nxq
铋	nei
锾	nryx
錾	bzn
镮	nltc
闰	du
阉	dml
霆	riyg
霏	rouu
颀	ztdv
飧	zwqc
馊	zfix
饔	qcoc
骋	gltg
骊	gtdq
骷	gfj
髅	gfrx
鳖	rxl
鳝	lwuh
鸪	jgt
麝	qvib
黠	lyrh
伢	osii
佞	oyx
伽	ofhv
佝	ofh
倨	ojj
刈	xo
剁	gmo
哂	hjv
哞	hcb
嗄	htkx
哝	hac
姘	xwv
寅	atlw
帏	dbsv
彘	jtif
徉	pwu
徜	ppdh
忒	ne
忝	tmp
怏	idm
愎	izkx
戕	znv
戛	tknz
挲	epib
搌	bjvc
摞	blcp
攮	bthc
斛	zfwb
旌	qziu
旎	qzjf
旖	qzmh
杞	msd
枋	mqv
桁	mpy
枭	gmc
梏	mbh
栋	mnp
榔	mqss
楦	matt
槁	mqhh
檄	mkqx
樯	mywh
毽	ubg
氆	uwpk
氇	ulk
氘	uo
浬	eky
淅	emz
湮	ejy
漕	evkk
沤	esx
濑	emhd
焙	ryh
煨	rltc
烩	rwyc
牒	zvdm
珂	uth
璀	udou
畚	cml
疸	qkt
痄	qziy
痈	qf
瞠	kpay
矍	kkox
硪	jibn
碡	jujw
磐	fgxj
磬	yjgj
磴	jztw
禘	aead
秕	pifv
稔	pwae
稗	plb
穰	pqhc
笈	zgq
笞	zchz
粑	rjv
糌	rxik
糯	rrtd
绀	cv
绛	cxbv
羼	jwuu
耪	bweq
耧	bwrx
胝	ffnq
芊	vib
苑	vzg
苓	vwaz
苫	vih
荸	vban
荽	vrxz
蓊	vwcs
蔫	vtor
荠	vqo
薮	vrxx
蚶	lv
蛭	ltcy
螫	ypxl
蠹	thil
觎	wfoo
觊	dsio
詈	luh
诨	gab
讴	gsxv
谩	gklx
谲	gcsh
谶	gwwn
赭	ypyk
趔	yoto
蹓	jfsl
蹴	jqhq
辔	cbch
逶	pxa
酊	jtt
釜	wxuw
铣	nbo
钡	ndv
锶	nle
镉	ntht
镌	noug
闩	dt
阕	dztm
霁	rqo
韭	ouut
颧	vhhd
饽	zban
餍	tmwc
驽	xxgz
骠	gjyp
鲠	ltkx
鲇	lih
鳟	lwjb
鲈	lij
鹧	qvrt
麒	qviw
麾	qmmu
龃	owdk
龈	owdc
龉	owdh
丕	tit
亳	qhan
仞	osq
仳	oif
伋	ogq
仵	ozb
佻	oor
佾	owfv
俎	wwkv
伥	onw
俳	oouu
偈	okfd
佥	we
刎	foo
卮	ztgc
呦	hcf
啕	hfzd
啶	hato
喟	hlf
喱	htky
哔	hifb
嘬	hkkx
噱	hinp
囝	hn
圜	hltc
圮	ysd
坷	yth
坼	yzq
坨	yaf
埚	yhdw
茔	vay
塍	fwmy
墁	yklx
妯	xlv
姣	xex
娌	xky
婀	xsth
婊	xuc
娅	xtp
婥	xikb
媛	xryx
媪	xkl
嬴	qhfq
嬗	xqht
嫱	xywh
孅	xwwn
娈	qpxz
孓	sqx
孚	rnz
寤	azuh
尥	nfqc
岘	ddo
崮	dhj
嵋	djk
岿	dos
帑	xxd
帙	dim
幄	djty
幛	dykb
帻	dud
庖	qfjc
廛	qkyy
庑	qtn
弼	gtkg
徂	pkv
徕	ptr
怍	iziy
恫	idth
悱	iouu
愀	ipr
愆	peye
恺	idsd
愫	iucp
悭	ioxy
怃	itn
怼	xbe
抔	bti
拑	bv
挈	bsbz
捯	btco
捵	bdvw
揆	bztm
揳	bbsm
揠	bskx
掴	bhuq
掺	bcmp
抟	bygq
摽	bjyp
撙	bwjb
挝	bba
摅	bine
晏	kax
晷	kxih
暝	kake
暹	koua
曜	kssu
杪	mpi
柢	mfnq
柤	mk
枳	mhw
桴	mrn
棼	mmws
楹	mgxl
椹	mvwd
槃	fgxm
榧	msou
槔	mkmb
椁	mqhn
槭	mnip
橛	mtww
栉	mvs
柽	mxy
椟	mywm
蘖	vihm
榉	mewb
歆	ykzw
歃	ibfw
殁	tzgx
殂	tzk
殍	tzrn
毹	wfou
氍	kkou
氙	udc
氚	up
氖	ugc
氩	utp
汕	ed
汊	exq
汔	ezg
汴	eqi
汶	eq
泓	egc
泖	efs
洱	ekv
洮	eorv
泾	ecy
浼	ezho
淖	eikb
湔	ewfo
湉	eiij
渫	evdm
溲	efix
溥	ebqb
溽	etyb
漳	eykb
潼	eyky
潸	emmf
浔	esb
渎	eywm
潴	epyk
滦	eqpm
炔	rsw
煆	rjyx
燹	ppr
牯	bjv
犋	bkwv
犍	bbg
犒	bqhh
狎	pki
獾	pvhu
玷	uihv
珐	uyc
琮	uayp
琤	uzsi
琏	uba
璜	uvlw
璞	upwm
玺	zpuq
瓯	sxtq
疽	qkc
痔	qyb
痍	qmg
痣	qye
痧	qepi
瘐	qfwc
瘗	qmwy
瘸	qfhw
癸	ztm
皈	kzx
皤	kirl
盍	ycl
睢	kouv
砭	jia
砣	jaf
碇	jato
碣	jkfd
硗	jnto
礌	jrl
砺	jtts
祐	abh
祚	aziy
禳	aqhc
秣	pbw
稂	pqsc
稃	prn
窈	awcf
竦	ymh
筱	zoix
箧	zsmw
箬	zvbh
粽	rayp
糨	rghl
纡	ctb
纨	cgqv
纻	cat
绁	cvd
缗	csik
缢	cwwl
缛	ctyb
缧	clcp
缶	zbdx
罹	liou
膻	fqht
聒	kij
聱	ufxk
肱	fbc
胼	fwv
腒	fjj
膙	fghl
臌	fyhx
舻	fij
芫	vyoz
苣	vss
苕	vsh
茌	voyz
茨	vwzw
茯	vom
莞	vayo
莘	vyb
荻	vpr
苋	vdo
莨	vqsc
菅	vah
萋	vtbx
菰	vnc
葧	vbaf
蒺	vqzm
蓍	vyfk
蔻	vayx
蓼	vssp
薤	vtzt
薅	vxtb
藜	vpfr
蛱	lmw
蜮	lnht
蝮	lzkx
螈	ltkp
螬	lvkk
螯	ufxl
螽	xwll
蛲	lnto
蛴	lqov
蝾	lvam
蛎	ltts
袂	asw
衲	adw
衿	awa
袪	ayc
袈	fhqc
袤	qcsc
裟	epic
褫	azig
裢	aba
襁	aghl
覃	jkb
觔	zff
觫	zfmh
觭	zfmh
觳	yatx
訇	fuh
讦	gyv
诂	gj
诠	gwuv
诟	gzth
诔	gbwv
诳	gpu
谝	gqjd
豉	thwx
貉	pxh
赓	qswd
赉	trd
赧	ypsx
趺	jmv
跦	jbw
跫	ygqo
蹉	jwuy
躐	jchr
轫	bsq
轾	btcy
辇	mmbz
逑	brqa
遑	kua
邈	pkoa
邰	chs
郤	rhs
鄂	hhys
酐	jty
醐	jtjf
醍	jtko
醮	jtor
醴	jthw
酽	jtti
钒	ngq
钍	nyv
钣	nzx
钯	njv
铚	ntcy
锉	nwwy
锟	nkif
锗	nyk
锸	nibf
鎏	eqcn
镓	nap
镨	nwpk
铄	nfp
阍	dfnk
阙	dwdw
阡	sib
阢	sto
阜	ihb
陉	scyv
隰	skcr
隽	oug
霖	rmm
霰	rvfx
靛	ufao
靥	tmtl
鞣	vlcm
韪	ktos
顼	utd
飙	mmmx
饴	zch
馐	zwuy
馔	zjjw
饕	htgc
馥	pkzx
骟	gqjs
髹	upom
鬟	uplc
魈	lcpf
魇	tmlc
鲳	lkk
鲭	lufv
鳏	llir
鲥	lkb
鲢	lba
鳕	lrs
鸢	ngtz
鹁	bant
鹗	hhyt
鸷	bgqt
鸶	cctt
鹭	jxht
鹳	vhht
麸	uxm
黉	eavw
鼐	gkzz
鼩	frfh
鼱	fruf
赍	bwwd
龚	bfqw
丌	tooo
乂	xxxx
乇	in
乜	sdx
乩	ihd
亍	yttz
亶	qhht
亹	qzyk
仂	ofv
仉	ogv
仡	ozg
佗	oaf
佤	otiq
佧	oii
佟	oxw
佘	wyp
侏	obw
侑	obf
佶	oyhv
佴	okv
侗	odth
侔	ocb
俑	ocf
俅	obrq
俜	oltg
倥	oawy
俵	ouc
倬	oikb
倜	ofyh
偲	ole
傣	omir
偬	ofxe
僇	ossp
傺	ozyp
僖	oyhh
僦	oqhq
偾	obvd
僳	ojr
僬	oour
僰	mdmw
侬	oac
儇	oltc
儋	ozth
俦	obb
傧	oazw
侪	oqo
傥	opaj
兕	igdo
兖	eco
冇	bd
冏	dwh
冱	wtjt
刖	fov
刳	mygo
刭	cyo
剡	rro
剒	vko
剞	mtho
剟	xxxo
剀	dsio
剽	jypo
劂	twdo
劁	ouro
劓	klto
劬	fhf
劭	shf
劻	suf
劼	yhf
勍	qhpf
勖	dykf
勰	fffe
劢	tsf
匏	mygj
匦	sbg
匮	sld
匽	skx
卌	vvvv
卍	gg
卞	qi
卣	ihs
卲	shs
厍	tbc
厣	tmki
叟	fix
叻	hfv
呔	hmq
吽	hb
咇	hei
咑	hbt
咈	hgo
呣	hjw
呤	hwav
咥	htcy
呙	hdwz
唦	hepi
哢	huv
哳	hbz
吣	he
哿	fhth
唑	hwwy
唎	hpo
唳	hqjm
啵	heix
唼	hyx
唪	hmb
唵	hml
啋	hrm
喑	hyk
喈	hifk
喵	hvl
嗉	hucp
嗌	hwwl
嗍	hwdf
嗾	hqzm
嘌	hjyp
嘏	jjyx
哓	hnto
呒	htn
哕	hdz
哙	hwyc
嚆	hvqh
啮	howd
呖	htf
喾	eabh
啭	hbyq
冁	wkbc
囗	hhhh
囟	hxc
囧	hwd
囷	hp
圊	huf
圬	yyg
圯	yjv
圪	yzg
圻	yz
坌	wsy
坩	yvv
坭	yjf
坫	yihv
坶	yjw
坻	yfnq
垓	yqcw
垤	ytcy
垌	ydth
埕	yhu
埒	yrb
垺	yrn
埤	ylb
埴	ybk
堀	yjdd
埭	ybr
埽	ysad
堋	yff
埏	yiog
垭	ytp
堍	yzhq
堠	yosm
堙	yjy
堞	yvdm
埘	ykbv
埙	yhd
垲	ydsd
塥	ytht
墉	yqbf
墀	yjib
墼	bkdy
圹	yqv
垆	yij
囍	yhwh
夔	wkox
夤	zatw
奀	tim
奅	mfs
奓	mzz
奁	msxz
姹	xain
妤	xcsi
妗	xwa
姒	xiqw
妲	xkt
姮	xtkt
姝	xbwv
娣	xwgi
娉	xltg
婠	xah
婕	xtso
婧	xuf
娲	xhdw
妫	xqfq
婺	csix
婼	xvbh
媸	xdtl
媵	fwmx
嫖	xjyp
嫘	xlcp
嫜	xykb
嫪	xssp
嫫	xvkm
嫠	bwxx
嬛	xltc
嫒	xrax
嬖	jhyx
嬲	lfxf
孖	nn
孛	ban
孥	xxn
屘	jun
孬	tixn
宄	agz
宓	aei
宥	abf
宸	atyc
尕	gpz
尢	nbd
尹	si
尻	jgc
屄	jaw
屌	jhd
屙	jsth
屣	jpoo
屦	jprx
屮	diii
屺	dsdv
岑	dwaz
岍	dtv
岈	dsii
岷	dsin
岫	dlv
岱	ondz
岵	djv
岣	dfh
岢	dthz
崁	dyzw
崆	dawy
崤	dxbf
崧	dmwc
崞	dqhn
崚	dywx
崃	dtr
崦	dmlv
崴	dnix
嵇	pnqd
嵫	dwcc
嵯	dwuy
嵊	dpif
嵬	dlc
嵝	drx
嶝	dztw
崂	dvaf
嶒	dwlk
峤	dimo
峄	dxbv
嶷	dfzo
巽	jjvw
帔	dix
帼	dhuq
帱	dbb
幪	dvap
庀	qfc
庋	qbx
庠	qwuc
庥	qom
庾	qfw
庹	qvjq
庳	qlb
厩	tsco
廨	qzfb
廾	vvvv
弁	cvz
弈	qpv
弋	nnq
弑	xmny
弢	gdx
弪	gcy
弶	gqhp
彖	jp
彝	jtrv
彧	nhtp
徼	pkqx
忉	is
忭	iqi
忮	ibx
忻	iz
怫	igo
怛	ikt
怙	ijv
怊	ish
怗	iih
恪	ixh
恓	ij
恂	ifkv
恝	bse
恚	yye
恧	tde
悝	ikyv
悃	ihm
悛	icwx
悗	izho
惇	iqhn
悰	iayp
惓	iwmg
惝	ipdh
恽	iab
茕	vagb
愍	sine
慊	iwsp
悫	yage
慝	svbe
愦	ildv
懔	iqhp
憝	qhne
怿	ixb
懋	mcse
戆	ykbe
戍	niq
戋	nnqx
戙	dthn
戢	hkn
戥	kiun
戤	gxln
戬	tpkn
戗	wgn
戽	qjwb
扃	qjdh
扦	bibv
抆	bq
抌	bao
扱	bgq
扽	bnd
拶	bcz
捌	bhfo
捃	bsih
挹	bhj
掊	byhv
掭	btmp
掎	bmth
揎	batt
揲	bvdm
掾	bjp
搦	bgww
摁	bhme
搋	bzig
搛	bwsp
搴	avwb
摭	bqvr
搿	uwhb
撖	bskx
挢	bimo
擗	bjhb
擐	bltc
摈	bazw
攉	brou
撄	bddx
敖	ufx
斌	qton
旆	qztd
旃	qzfq
旄	qzu
旒	qzqp
旰	kyv
昀	kfw
昕	kz
昊	ktm
旻	kq
昃	ktw
昱	kyz
昶	qsrk
昝	xik
昴	kfsz
晁	korz
晟	knf
晞	kxbd
晡	kbq
晖	kabv
暄	katt
旸	kgo
暌	kztm
晔	kofb
暾	kqhx
曌	kfay
曚	kvap
曩	kqhc
曷	kfwd
朊	fyo
朐	ffh
杌	mto
杲	kmz
枘	mdwv
枸	mfhv
枰	mywv
柙	mki
柝	mzq
柒	enm
柘	mjv
枵	mhtg
柰	mypz
柃	mwa
栟	mwv
栲	mytg
栳	myf
桄	mpto
栝	mijv
梃	miyg
栀	mztg
桫	mepi
楮	mykv
棓	myh
枨	mnw
椓	mpq
椐	mjj
椋	mqhp
桢	mid
楱	mmtm
楗	mbg
棰	mity
楸	mpr
椴	mzux
榫	moub
榱	mqhc
榍	mjpf
桤	mdsd
槊	wdfm
杩	mgv
樗	mryg
槿	mvhu
槲	mzfb
椠	bzm
樘	mpay
桡	mnto
樾	myoi
樨	mjib
橐	thim
檗	jhym
檠	vfhm
檎	mwqc
檑	mrl
梼	mbb
槠	mgyk
橼	mcjp
榇	mym
栊	mbfq
枥	mtf
栌	mij
栾	qpmz
椤	mlz
欹	mthw
歙	whsw
欤	tgtw
殄	tzwp
殛	tzst
殇	tzzo
殪	tzyw
毌	jb
毐	yjb
毓	zjwp
毳	uuu
毵	cmpu
牦	bu
氐	fnq
氕	ui
氪	ujo
汆	wirz
汜	ejv
沅	eyo
沆	eqg
沔	etds
沂	ez
汩	ekv
泗	eho
泠	ewa
泫	eqc
泮	ewbv
沭	emqv
泐	esf
沊	aoir
洹	etkt
洧	ebf
洵	efk
洎	ekv
洫	eil
洴	ewv
洳	exhv
洙	ebwv
洚	exbv
洑	eom
洇	ehm
浃	emw
浣	eayo
浯	euh
涑	emh
浠	exbd
涮	ejdo
渚	eyk
淄	ecl
涪	eyhv
涫	eah
涞	etr
淠	elto
淝	efjv
渥	ejty
湟	eku
淼	irir
沩	eqfq
浈	eid
湓	ewsl
溘	eycl
溧	ejm
溏	eqbh
溟	eake
溱	emp
滁	eswm
溷	ehp
滏	ewxw
漯	elcp
荥	vair
漶	ehhe
滹	einb
漭	evmv
溆	ewmx
颍	fird
澍	eyhb
澉	eskx
澌	evwz
潲	eppf
涠	ehbs
滗	ezu
濂	eqwp
澧	ehvw
澶	eqht
渑	ehl
潞	ejxh
浍	ewyc
濉	ekou
濠	eqhp
濮	eopm
潍	ecou
泶	eair
濞	eklo
滢	evaq
泺	efp
瀛	eqhq
泷	ebfq
潆	evap
瀣	eizt
潋	ewex
瀵	erlw
瀹	ewhd
沣	ebv
滠	ekxx
灞	ervf
灏	ekqd
滟	ebzj
炅	krz
炆	rq
炱	chr
烜	rtkt
烝	srtr
缹	zbdr
烚	rwh
焗	rjsh
烃	rcy
焌	rcwx
焐	ruh
焓	rwah
焜	rkif
焠	rqwb
焯	rikb
焱	rrr
煜	rkyv
炜	rbs
煲	ohmr
煸	rqjd
炝	rwg
熵	redh
熳	rklx
烨	rofb
燔	rirl
燮	uhrx
燠	ridm
焘	bbr
爝	rrlb
爟	rvhu
爨	zydr
爰	ryxz
牖	zqjq
牮	onb
牾	buhv
牿	bbh
荦	vabz
犰	pgv
犴	pyv
狃	psy
狁	pco
犺	pqg
狨	pnb
狷	phf
狺	puh
狴	pify
狳	pwmv
狻	pcwx
猁	ppo
猓	pkmv
猗	pmth
猊	pfov
猞	pwyh
猱	pcsm
猷	wjtm
獍	pyko
獒	ufxm
獬	pzfb
猃	pwe
狯	pwyc
狝	pzp
獯	pitr
猕	pgzp
玎	ut
玖	uzq
玕	uy
珏	uuq
玟	uqv
玥	uf
玦	usw
玢	uwsv
玠	uwo
珈	ufh
珅	uki
珙	uvwv
珥	ukv
珧	uor
珩	upy
琇	upg
珺	usih
琨	ukif
琬	uazg
琰	urrv
琚	ujj
珲	uab
瑛	uvdm
瑄	uatt
玮	ubs
瑭	uqbh
玱	uwg
璋	uykb
瑾	uvhu
璇	uqzo
璁	uhxe
玑	ugv
璟	ukqp
璠	uirl
璩	uinp
瑷	urax
珰	ups
璺	zydq
璎	uddx
瓒	ubod
瓞	cim
瓠	mygc
瓴	watq
瓿	yhtq
甍	vlaq
甑	wlkq
甏	yhwq
甓	jhyq
罂	ddzd
畀	ltoz
甾	clz
畎	lmv
畋	lx
畈	lzx
畛	lwp
畬	wml
畹	lazg
疔	qt
疥	qwo
疣	qnq
痂	qfh
疰	qqu
痱	qouu
痦	quh
痤	qwwy
瘀	qqww
痿	qpxc
瘃	qpq
痾	qsth
瘕	qjyx
瘥	qwuy
瘙	qxql
瘛	qbse
瘘	qrx
瘭	qjyp
瘳	qssp
瘼	qvkm
瘵	qzyp
瘰	qlcp
癃	qsxu
瘅	qwkb
痫	qdm
疠	qts
癜	qjvx
皋	kmb
皕	tktk
皴	cwxx
皲	abix
盥	zyil
盱	ktb
眇	kpi
眄	ktds
眙	kch
眚	iuk
眢	zgk
眭	kyy
眦	kof
眵	kzzv
睇	kwgi
睥	klb
睚	ktyy
瞀	csik
瞍	kfix
瞢	vlak
瞵	krzb
瞽	yhwk
瞿	kkou
矧	zmgi
矬	zmwy
矸	jyv
砑	jsii
砒	jifv
砉	bjz
砟	jziy
砬	jy
砢	jth
硎	jtvo
硒	jjv
砦	ofj
硐	jdth
硖	jmw
硭	jvq
砗	jbv
碓	jou
碚	jyh
碲	jead
砀	jgo
碥	jqjd
磔	jzbm
磉	jxxm
碛	jud
磲	jesm
礅	jqhx
硚	jimo
礓	jtlt
礞	jvap
礤	jvzw
砻	bfqj
祊	aq
祗	afnq
祛	ayc
祜	ajv
祓	abxq
祧	aor
祫	awh
禊	absm
祎	abs
禚	awur
祃	ag
祢	azp
禺	kdiq
籼	rdv
秭	pigi
稹	pbkw
秾	pac
稆	phhv
穸	awz
窀	awnd
窆	awia
窕	awor
窨	awyk
窬	awwo
窳	awcc
窭	awrx
竑	ybc
笄	ztv
笏	zfo
笊	zrz
笮	zziy
笥	zsth
笳	zfh
笪	zkt
笱	zfhz
笫	zigi
筊	zex
筇	zys
筌	zwu
筘	zbh
筅	zbo
筠	zyfw
笕	zdo
箜	zawy
箐	zuf
篪	zzig
箅	zlto
篁	zku
篌	zosm
蓑	vqhc
篦	zhxf
篥	zjm
篚	zsou
簏	zqvf
箦	zud
簋	zscl
筚	zifb
箪	zwkb
簟	zjkb
簦	zztw
籀	zbfl
箨	zbxb
箓	zsir
簖	zrdz
笾	zfa
糁	rcmp
粢	wzwr
粞	rjv
粳	rtkx
粲	izxr
糅	rcsm
糈	rsof
糗	rkm
粝	rtts
籴	wr
糸	cppp
纴	ciy
纾	ccsi
绋	cgo
绂	cbxq
绐	cch
绖	ctcy
绗	cpy
绦	cxm
绨	cwgi
绠	ctkx
绡	cpf
绾	cah
缁	ccl
绻	cwmg
绲	ckif
綦	vwcp
綮	qjxp
缂	cvl
缇	ckto
缃	cmk
缌	cle
缏	cotx
缑	cosm
缟	cqhh
缙	ctpk
缊	ckl
缒	ciha
缦	cklx
缡	cqxc
繇	rzbp
縻	qmmp
絷	bgqp
缋	cld
缲	chhm
缳	cltc
缱	clha
纩	cqv
缬	cyhd
缵	cbod
纛	ujwp
罘	lti
罟	ljz
罡	lto
罨	lml
罾	lwlk
罴	lycr
羌	wud
羝	wufq
羟	wucy
羧	wucx
羯	wukd
羰	wudr
羸	qhfq
翊	yss
翥	ykss
翦	wfos
翮	thds
耄	yfu
耋	yfty
耔	bwn
耖	bwpi
耦	bwkq
耨	bwtb
耩	bwvy
耵	ktv
聃	kdy
聩	kld
聍	kat
聿	bsb
肓	qfz
肜	fpv
肭	fdw
胂	fkiv
胙	fziy
胗	fwp
胍	fcv
胴	fdth
胲	fqcw
脘	fayo
脬	frn
脞	fwwy
腍	fwae
腠	fmtm
腩	fbdy
腧	fwfo
脶	fhdw
膈	ftht
膂	qzcf
腽	fkl
膣	fawy
膑	fazw
臑	frtd
胪	fijv
脔	qpdw
臬	kmz
舁	fv
舂	mf
舄	ffr
舡	fyv
舨	fzx
舯	fhiv
舸	fth
舳	flv
舴	fziy
艉	fju
艋	fnl
艏	fwk
艚	fvkk
艟	fyky
舣	fqx
艨	fvap
艮	sc
艴	gozj
艽	vgz
艿	vgz
芏	vy
芎	vgz
芑	vsd
芄	vgqz
芰	vbx
芾	vtd
芷	vo
芘	vif
芮	vdw
芴	vfo
芨	vgq
芡	vzw
芩	vwa
芤	vnd
茆	vfs
茇	vbxq
茺	vqco
苴	vkz
苡	viqw
苻	vob
苤	vtit
苠	vsin
荏	voiy
茳	vey
荑	vmg
茜	vjz
茛	vsc
茈	vofz
茼	vdth
荇	vpy
莆	vbq
堇	vhu
莩	vrn
莛	viyg
莪	vibn
莰	vyzw
菽	vipx
萸	vfwz
菔	vfsx
菟	vzhq
菏	veth
菹	vek
菀	vazg
萁	vvw
菝	vbbq
菥	vmz
菘	vmwc
菡	vsrd
菖	vkkz
萏	vzf
萑	vou
萆	vlb
菪	vaj
萱	vatt
葭	vjyx
葆	vohm
葶	vqht
葑	vyyb
葙	vmk
葺	vhk
葸	vle
萩	vpr
荭	vcyz
蒎	vezc
荪	vnp
蒗	veqc
蒡	veaq
蒹	vwsp
蒴	vwdf
蓁	vmp
莳	vkbz
蒯	vffo
蔟	vqzm
蔌	vmhw
莼	vcnd
荜	vifb
蒌	vrxz
茑	vgt
蓰	vpoo
苁	vww
蕙	vtke
蕖	vesm
荛	vnto
蒇	vnid
蕤	vpiu
荨	vsb
蒉	vld
莸	vpnq
芗	vc
薜	vjhb
薨	vlaf
蓟	vlo
薏	vyke
蕻	vuvw
蓣	vcsd
蕺	vhkn
蕹	vqcu
莶	vwe
薹	vyhy
荩	vjqw
薷	vrtd
蔺	vdou
茏	vbfq
藿	vrou
苈	vtf
蕲	vwkz
蘅	vpzy
蘧	vina
蘩	vzjp
蔹	vwex
蓠	vqxc
齑	qoot
蘼	vqmu
虍	innn
虢	rbig
虬	ldv
虮	lgv
虻	lqv
虺	tol
虼	lzg
蚨	lm
蚍	lifv
蚋	ldw
蚧	lwov
蚵	lth
蚺	ldy
蚰	llv
蚴	lcfv
蛘	lwuv
蛩	ygql
蛑	lcb
蚬	ldo
蜊	lpo
蛸	lpf
蜍	lwm
蜩	lfyh
蜣	lwud
蜞	lvw
蜾	lkm
蜱	llb
蜚	ouul
蝤	lwjt
蝻	lbdy
螗	lqbh
螓	lmp
蛳	lotd
螳	lpay
螭	lqxc
螵	ljyp
蟊	csil
蟛	lyhp
蟪	ltke
蟥	lvlw
蟓	lzhp
蟾	lzth
蠃	qhfq
蛏	lxy
虿	tsl
蠊	lqwp
蠓	lvap
蠖	lvox
蠡	jpll
蠛	lvlq
蠲	wwll
蠼	lkkx
衄	ilsy
衢	pkky
袢	awb
袼	axhv
裉	asc
裒	qfc
裎	ahu
裴	ouuc
褚	ayk
裾	ajj
裼	akfo
褙	aiyf
褰	avwc
幞	dpwm
裥	adk
裣	awe
襞	jhyc
襦	artd
襻	amxb
觇	ihdo
觋	ywwo
觏	vdyo
觌	ywmo
觖	zfsw
觚	zfc
觥	zfpo
觜	ofzf
觞	zfzo
觯	zfwb
讧	gy
讵	gssv
诎	gdd
诒	gchv
訾	ofuh
诓	gsu
诖	gyy
诜	gbo
诰	gbh
诶	gczm
谇	gqwb
诼	gpq
谂	gwae
谌	gvwd
谖	gryx
谔	ghhg
谥	gwwl
谡	glwx
謇	avwh
谟	gvkm
謦	yjgh
谯	gour
谮	gsok
谵	gzth
谫	gwfs
谰	gdml
谳	gbdm
谠	gpaj
豇	thwy
豕	ptp
豳	dpp
貊	ptk
貅	pomv
貔	phxf
貘	pvkm
贲	bvd
贶	djv
贳	vddz
赀	ofdz
赇	dbrq
赒	dfyh
赕	drr
赆	djqw
赙	dbqb
赜	sihd
贽	bgqd
赑	ddd
赝	tood
趼	jtvv
跂	jbx
跆	jch
跖	jjv
跏	jfh
跗	job
跬	jyyv
跣	jbo
跽	jsde
踡	jwmg
踣	jyhv
踦	jmth
踔	jikb
蹀	jvdm
踽	jild
蹁	jqjd
跸	jifb
蹼	jpwm
蹯	jirl
趸	tsho
踬	jzbd
躔	jqky
跹	jiba
跞	jfpv
躞	juhx
躜	jbod
轲	bth
轺	bshv
轵	bhw
轸	bwp
辂	bxh
辁	bwuv
辋	bdwq
毂	yabx
轹	bfp
迍	nda
迕	zba
迮	ziya
逅	ztha
逄	xbac
逖	pra
逋	bqa
逭	aha
逯	sira
遒	wjta
遄	dtda
遘	vdya
遢	kssa
邅	qhha
邋	chxa
邙	qsv
邗	ys
邛	ysv
邢	tvs
邡	qsv
邠	wss
邶	iyis
邴	tdws
邯	vsv
邳	tits
郃	whs
郅	tcys
邾	bwsv
郇	fks
郝	yps
郢	hus
郏	mws
郛	rns
郗	xbds
郜	bhs
邕	chj
郯	rrs
郪	tbxs
郴	mms
郫	lbs
郾	skxs
郓	abs
鄄	jys
郿	jks
郧	hds
鄞	vhus
鄣	ykbs
鄢	tots
鄯	wuws
郸	wkbs
邺	psv
郐	wycs
鄹	kxps
酃	rhhs
酆	dbbs
郦	tdqs
酉	jt
酎	jtb
酏	jtvv
酡	jtaf
酤	jtj
酢	jtzy
酩	jtzh
酴	jtwm
酲	jthu
酹	jtrb
醅	jtyh
醑	jtsf
醢	jtbl
醯	jtql
醪	jtsp
醭	jtpm
醵	jtip
酾	jttq
钇	ng
钆	ndv
钊	nov
钋	niv
钌	nsv
钏	npv
钕	nxv
钤	nwav
钫	nqv
钬	nr
钭	nwb
钪	nqg
钹	nbxq
铉	nqcv
铍	nix
钿	nlv
铊	naf
铈	nqd
钰	nuq
钲	ntov
钶	nth
钺	nni
铳	nqco
铌	njf
钽	nkt
铱	nqc
铦	nij
铒	nkv
铑	nyf
铕	nbf
铟	nhm
铫	nor
铯	nzj
铪	nwh
铷	nxhv
铖	nnf
銎	ygqn
铥	niyc
锂	nky
锒	nqsc
铗	nmw
铽	nne
锓	nsax
铓	nvq
锊	nrb
铤	niyg
锆	nbh
锇	nibn
鋈	eimn
锔	njsh
锬	nrr
锖	nuf
铼	ntr
锛	nmbv
锕	nsth
锞	nkmv
钔	ndv
锲	nbsm
钖	ngo
锷	nhhg
锴	nifk
锽	nku
鍪	csin
锼	nfix
镕	narh
镒	nwwl
镋	npaj
蓥	van
镝	nedj
镞	nqzm
镛	nqbf
镪	nghl
镆	nvkm
铩	nxm
鏊	ufxn
铙	nnto
铴	nego
镦	nqhx
镡	njkb
镄	ngod
镤	npwm
铹	nvaf
镱	nyke
镔	nazw
镳	nqvr
鑫	nnn
镧	ndml
闫	duc
闳	dbc
闶	dqg
阆	dqsc
阃	dhm
阏	dqww
阈	dnht
阊	dkk
阌	drax
阒	dkm
阗	dbkw
阚	dskx
闼	dma
陂	sixv
阽	sihv
阼	sziy
陔	sqcw
陟	sop
陴	slb
陬	skxv
陲	sity
隈	sltc
陧	sky
隗	slc
隳	sbyp
隼	oub
雎	kou
雒	xhou
霈	retd
霂	rem
霪	rery
靳	vlzv
鞔	vlzo
绱	cpdh
鞫	vlfh
鞯	vlvn
韬	bsrf
韫	bskl
颃	qgtd
颛	dtdd
颡	xxxd
颢	kqhd
颞	kxxd
飑	gxfj
飓	gxkw
飏	gxgo
饫	zimv
糍	rwcc
饧	zgo
糇	rosm
餮	tzwc
饩	zuv
馗	gwk
馘	wknt
驲	gk
驷	gho
驵	gkv
骀	gch
骐	gvw
骓	gouv
骛	csig
骞	avwg
驺	gzsv
骝	gfsl
骘	sopg
骢	ghxe
骖	gcmp
骜	ufxg
骣	gjnn
骅	gofb
骥	giyw
骉	ggg
骱	gfwo
髁	gfkm
髀	gflb
髂	gfah
髑	gfll
髌	gfaw
髋	gfao
髟	uppp
髡	upto
髫	upsh
疬	qtf
鬈	upwg
阋	dfo
阄	dzkd
鬯	xrdf
鬲	thdt
鬻	grgt
魃	lcbq
魉	lctw
魍	lcdq
魑	lcqc
鱿	lnq
鲂	lqv
鲋	lob
鲐	lch
鲔	lbf
鲒	lyh
鲕	ltd
鲦	lxm
鲩	layo
鲷	lfyh
鲮	lywx
鲰	lkx
鲲	lkif
鲵	lfo
鲻	lcl
鲞	wml
鲱	louu
鲽	lvdm
鳆	lzkx
鳇	lkuv
鳎	lkss
鳐	lrzd
鲣	loxy
鳓	lvlf
鳌	ufxl
鳜	ltww
鲟	lsb
鲎	eal
鳢	lhvw
鲚	lqo
鲡	ltdq
鸩	aogt
鸨	fbgt
鸰	wagt
鸮	htgt
鸲	fhgt
鸱	fnqt
鸸	tdgt
鸺	omgt
鹈	wgit
鹆	rhgt
鹒	qswt
鹎	lbgt
鸫	npgt
鹕	jfgt
鹚	wcct
鹙	prgt
鹣	wspt
鹘	gfgt
鹠	fslt
鹨	sswt
鹩	mkpt
鹪	ourt
鹫	qhpt
鹇	dmgt
鸬	ijgt
鹾	ihxy
麂	qvig
麈	qviu
麇	qvip
黟	lyrz
黥	lyrp
黧	pfir
黪	lyrp
黡	tmlr
黩	lyrm
黹	pr
黻	prbq
黼	prbq
黾	hlz
鼋	yohl
鼍	hhll
鼙	yhwb
鼢	frws
鼬	frl
鼯	fruh
鼹	frkx
鼷	frrm
鼽	kltg
齁	klth
龀	owdf
龁	owdg
龆	owdh
龅	owdj
腭	fhhg
龠	whhd
於	qww
牠	bv
係	oicp
乾	bkbg
妳	xzp
徵	pdtx
瞭	kmkp
喫	hbsm
昇	kiv
唸	hwae
迴	hha
弔	gi
夥	kmzz
摺	bssk
傢	oap
甦	tkxu
揹	biyf
濛	evap
慄	ijm
徬	peaq
迺	ja
棹	mikb
剋	joo
矇	kvap
瑯	uqss
仝	wyz
瞇	kra
矽	jz
濬	eiak
瞋	kbkw
菸	vqww
衒	pqcy
亓	yoz
噉	hskx
廑	qvhu
懞	ivap
扞	by
扺	bfn
暸	kmkp
曛	kitr
浥	ehj
煖	rryx
燐	rrzb
牴	bfnq
犛	bwxb
珮	ugtd
琊	usis
璿	uiak
甯	aef
碁	vwj
箝	zbv
肏	wdww
脩	oixf
袷	awh
貍	pky
跼	jjsh
蹧	jvkk
迆	va
吖	hwi
痖	qtp
坂	yzx
吡	hif
飚	gxrr
鳊	lqjd
抦	btdw
浜	eztw
噃	hirl
钸	nbdv
犇	bbb
卟	hiv
鲅	lbxq
猹	pmkt
馇	zmkt
镲	nazp
罉	zbdb
邨	nds
讬	gin
憷	immo
吲	hgi
雠	ougu
蝽	lmk
肽	fmq
煅	rzux
哋	hyv
莜	voix
啲	hkfq
腚	fato
揼	bjir
噔	hztw
厾	gyc
岽	dnp
哣	hthw
篼	zkfo
哚	hgm
砘	jnd
覅	jxfo
倮	okm
嚯	hrou
镢	ntww
唿	hfoe
绔	cmyg
㗎	hfhm
枧	mdov
硷	jwe
曱	ki
攰	bxf
擀	bbky
劐	vouo
藁	vqhm
苷	vv
㓤	yho
鞴	vlvf
鞲	vlvy
犟	ghlb
苄	vqi
桊	wmm
㷫	yjgr
㞹	dth
嗬	hvoh
钎	nib
冚	ad
睺	kosm
馕	zthc
咤	hain
劄	zwho
嵖	dmkt
揸	bmkt
齄	kltt
膪	feah
甴	ki
啫	hyk
嵴	drwf
肼	fvv
噍	hour
嗞	hwcc
谘	gwzh
喆	yhyh
锘	nvbh
睃	kcwx
黢	lyrx
腙	fayp
锺	nity
鳙	lqbf
呪	hj
着	wuk
咔	hiiv
芪	vfn
癯	qkku
鞒	vlio
轱	bjv
桕	mfv
叁	cmu
漤	emmx
唥	hwwa
嚟	hpfr
臁	fqwp
梿	mba
俫	otr
镙	nlcp
垅	ybfq
撸	blk
镥	nlk
粦	rzbb
嘞	hvlf
冧	amm
啉	hmm
熘	rfsl
犸	pgv
卐	gg
勐	nlf
芈	ottb
脒	frv
嫑	tijx
酶	jtzw
麽	qmmc
珉	usin
鳘	zjwl
掹	bnl
擝	bkfl
踎	jtih
乸	vjw
嗱	hwhb
镎	nwhb
伲	ojf
鲶	lwae
萘	vmyp
胬	xxdw
埝	ywae
嫐	xlfx
疴	qth
筢	zbj
嘭	hyhp
粃	rif
呯	hyw
噼	hjhb
犏	bqjd
嘣	hdff
堃	qqy
馓	zvfx
嗻	hqvr
镟	nqzo
鹮	ltht
畲	wypl
俬	opc
咝	hcct
胩	fii
蟮	lwuh
锍	nqcp
裇	ail
噻	havy
渖	eaki
嗮	hkj
嘥	hpoo
舾	fjv
傈	ojm
墑	yedj
墒	yedh
礵	jrmk
兲	uw
枱	mch
煺	rsca
沲	ezv
㓥	pso
鼗	oryx
凼	ird
氹	gir
趷	jzg
氽	wirz
撚	bzmr
脷	fpo
酞	jtmq
睩	ksir
睄	kpf
嗵	hcfa
埞	yato
唞	hbwb
肶	fif
㶶	rac
嫲	xqmm
锎	ndtv
惗	iwae
趌	yoyh
揗	bzbk
岙	imd
踭	jzsi
揞	byk
䟴	jtyc
噏	hwhs
钚	nti
癀	qvlw
煳	rjfv
啩	hyyi
郄	xbcs
䢛	dwha
垧	yidh
烱	rdwh
苘	vdh
馃	zkm
咣	hpto
馀	zwm
吔	hv
铘	nsis
仫	oic
祆	atm
弍	ny
茚	vfts
喐	hbfs
剦	mlo
埯	yml
亻	oooo
廴	gggg
衤	aaaa
阝	ssss
讠	gggg
幺	ccc
冂	dddd
亠	qqqq
扌	bbbb
忄	iiii
氵	eeee
彡	pppp
丨	iiii
丬	iiii
厶	ccq
冖	aaaa
宀	aaaa
攵	xxxx
疒	qqqq
丿	iiii
攴	ixxx
礻	aaaa
纟	cccc
饣	zzzz
彳	pppp
辶	aaaa
卩	ssss
丶	qqqq
犭	pppp
钅	nnnn
彐	ssss
灬	rrrr
刂	oooo
艹	vvvv
口	h
勹	ffff
豸	piwp
匚	ssss
冫	wwww
隹	ouv
耒	bwx
殳	gxz
凵	dddd
夂	xxxx
髎	gfsp
髃	gfkq
骻	gfmg
骶	gffq
锿	nqhc
锫	nyh
锪	nfoe
锩	nwmg
锠	nkk
锝	nktb
锏	ndk
锃	nhu
磙	jecc
碹	jatt
碔	jton
硵	jihx
砼	jwy
砹	jvx
砩	jgov
砜	jgx
獴	pvap
狍	pfj
燻	ritr
煊	ratt
浛	ewah
槥	mbbs
榅	mkl
巛	cccc
垵	yax
嘡	hpay
嘚	hpkb
哷	hrb
咹	hax
〇	hh
蔇	vsco
筕	zpy
骾	gftx
㣗	pqj
惃	ikif
㘳	iyfy
脰	fthw
嵶	dgww
猀	pepi
䵲	lyrm
㢴	ghx
幖	djyp
詟	bfqh
浫	eawy
䓪	vkfo
藋	vssu
胉	fk
畓	irl
埐	ysax
䰝	thdk
崊	dmm
遼	mkpa
埁	ydwa
仚	wd
䧈	sj
瑏	uawi
薸	vejp
䒖	vgb
钘	ntv
墎	yqhs
呠	hmt
扅	qjzz
壈	yqhp
䣗	kmbs
踑	jvw
㠙	dqhp
㑰	ojp
蚙	lwa
嶐	dsxu
凃	wwm
泇	efh
㽿	qc
㜣	xzmr
碈	jfnk
毭	thwu
㠞	pdtd
浲	exb
癷	zyyy
澷	eklq
堩	yitt
䗘	lycl
䆶	awor
媑	xity
噋	hqhx
㩟	bavm
䩜	vll
㿻	yl
㽸	qao
蘙	vszs
汎	egq
䒃	fbha
鄰	rzbs
眒	kki
㿡	kor
朲	mw
㺈	pdtl
毝	up
㸧	siic
蜼	lou
㦺	tycn
䯇	gff
膯	fztw
丩	iiii
㘰	ywb
蜋	lqsc
㢫	gd
艖	fwuy
翤	hdss
櫡	mzyk
䧹	qoou
榖	yatx
攱	ybx
㳉	ef
毻	byfu
㼺	qbhq
螇	lrcm
柂	mzv
娭	xczm
嵱	darh
孧	cfn
嵉	dqht
湐	emk
㿾	atl
䪧	ykv
丷	wwww
㤫	bfe
䵟	lyry
㼌	cc
㯅	mqlb
䧡	sqbf
㿴	mkix
犽	psii
薕	vqwp
癛	qqhp
㸖	wxk
䩥	vlig
舥	fj
䝈	pztg
薃	veqh
毲	xxxu
髨	upyo
䏻	cfyc
㯜	mvqb
㤏	ixw
徯	prcm
魋	lcou
荓	vwv
蔐	vedj
㣀	gbkw
楙	mcsm
雬	rm
䯕	gfig
碃	juf
靕	touf
枆	mu
浘	eju
眀	kf
朓	for
郔	iogs
恉	ifk
㻟	ubyf
䣩	jtnd
簎	zbvk
哵	hhfo
㱰	tzab
琩	ukk
煁	rvwd
栢	mtk
䄰	psii
荢	vatb
栬	mzj
愹	iarh
㝝	amm
垔	jyyy
䶂	frfq
苼	viu
渮	evth
䂄	kkkx
呧	hfnq
蘪	vqvr
蘣	vvlu
帺	dvw
峢	dtzo
螕	lhxf
襣	aklo
歚	wuww
痵	qpn
夝	ziu
䊗	rku
塗	ewmy
䂵	jyd
鹥	szmt
䶉	frfl
炂	rwc
懱	ivlq
䴠	qvim
円	dit
㗐	hmql
䶄	fryw
郷	cscs
朌	fws
兺	wshf
䘬	anb
㚌	zzkm
邿	ybs
䔠	vmpf
鄃	wfos
荿	vnf
膟	fqcb
䥿	nzts
䣛	mwis
㫍	qzox
㧰	bfp
䃠	jqzo
㶘	ezjb
楻	mku
莮	vlf
䘛	ag
㓊	wdth
秇	pgq
㛩	xqcf
皼	yatx
叅	cccp
湦	ekiu
㵖	exhp
杺	me
涰	exxx
粆	rpi
堺	ylwo
哾	hwj
畝	qlzq
㭠	mbo
䆏	prlw
慓	ijyp
妢	xws
偺	oxik
桲	mban
㵟	epdx
辻	ba
砡	juq
䆫	awfe
穅	pqbr
艅	fwm
濲	eyax
拫	bsc
㭵	mfl
韷	ykdd
溚	evwh
䐄	fzf
瀖	erou
㓫	mtvo
䂧	jzp
膌	frwf
婂	xkd
䰃	upwp
犎	yybb
㓁	awww
鄏	tycs
㛗	xwwy
㗫	hzyp
湗	eyyb
纼	cgi
呋	hmv
䣅	tycs
蹘	jssp
㳷	efok
峔	dyf
挭	btkx
衹	afn
慅	ixql
㶧	rdw
㽰	ffso
貀	pdd
㖘	htyc
䩘	vltc
栐	mqsr
陻	sjy
玭	uif
仺	wst
萐	vtso
耯	bwvx
酂	bobs
犗	babh
椃	ming
決	esw
㾙	qxbd
赩	ypzj
篐	zmsd
炴	rdm
颥	rtdd
偱	ozbk
㓹	trro
亇	ziii
翉	mtss
竬	yild
嶳	dpyy
夦	vwdz
傃	oucp
簠	zbql
瘣	qlc
䨄	waju
䔯	vjtj
䣉	epij
炑	rm
豾	ptit
烻	riog
韼	ykxa
䣎	cls
觮	zfsr
尰	nity
蔂	vlcp
韮	vout
溰	edtw
泎	eziy
猋	mmm
瓬	qtiq
黴	pdtx
偯	oqhc
轷	biwb
涍	eyn
媃	xcsm
㴾	ebax
遧	ykba
㗇	hjyx
㢽	gkg
壷	yaht
挼	brx
髊	gfwy
㥴	izig
溵	ezsx
栂	mjw
鬕	upvm
㙇	ypq
溨	ebmn
㟭	dsik
傶	onip
翗	zzss
䟓	jt
弤	gfnq
㶵	oiyr
廐	qsco
㥘	iycq
㠇	dqhq
㷰	rqxc
傚	oexx
䐎	fkto
㱥	tzyx
竾	zv
㕀	lg
灀	ermk
㢢	pdhv
翛	oixs
䧓	sfyh
㺸	ogqu
怹	ove
倅	oqwb
赿	yofn
榣	mrzd
嗃	hqhh
㾇	qk
䀱	kxb
㥥	ikdq
簲	zflb
㳦	env
堛	ythl
飗	gxfl
庎	qwo
苚	vf
㣸	pppu
㣥	poyb
苮	vod
醌	jtkf
寉	aou
㟛	dbv
㝊	ax
煿	rbqb
翖	whss
䑟	razu
舓	ijko
䄡	azth
猒	kfm
䝝	pmth
㠺	dpi
螣	fwml
䟛	jtd
溾	elc
㧛	ozb
裪	afzd
侜	of
䕯	vjyc
秡	pbxq
䈝	zsof
哬	hoth
佇	oat
樚	mqvf
䇧	zthw
䝎	pdtd
䖠	lgq
葕	vpey
瞨	kpwm
斠	vdyb
棌	mrm
㫮	ofk
䔼	vsqo
椈	mfr
捪	bfnk
僼	ohvw
箼	zjty
秊	pib
阨	stg
䗩	lnip
䕁	voum
汯	ebc
禼	ihxc
勥	ghlf
菃	vess
㑼	olxh
盁	gl
㨢	bcff
睝	pfik
暋	sink
秨	pziy
稬	ptdm
湭	ewjt
岲	dj
㳝	eoiy
劅	lflo
檙	mkzz
懅	iinp
旹	dtk
匎	fml
㹲	pyn
㕝	jx
崲	dku
葃	vkzy
馌	zycl
杬	myo
倓	orr
掱	bbb
揜	bwhv
䗉	lkk
㼭	yihq
竢	yczm
旂	qzz
禠	azig
䞪	yosz
欮	wdzw
瓧	tigb
亗	dy
膅	fqbh
䉰	zgfx
藮	vmor
篕	zycl
㮮	mbsb
趯	yosu
撯	bwuk
䞲	yoin
㠍	doum
䧾	wyhu
䇂	yi
矨	zmim
蝛	lnix
猸	pjk
㕯	dwh
䗢	lbha
蓱	vewv
呹	him
宒	au
䏗	fu
伝	oyc
蓢	vqsf
䄔	aild
螀	izbl
糏	rjpf
竳	yztw
䈷	zmxh
袛	afnq
缍	city
翀	sshi
淎	emb
廝	qvwz
炣	rth
䅄	pfff
腗	flto
䞻	yocf
僛	ovww
䟜	jdw
祔	aob
彣	qp
兗	ej
䏴	fpf
䞡	yokt
嵻	dqbr
稾	qhdp
婙	xzsi
䇮	zoiy
弆	ycv
彂	pgzm
棏	mktb
㫛	kj
䒨	vzm
禩	alvw
満	evdd
攃	bvzp
冺	wsin
阰	sif
渋	eor
拕	baf
㺫	uo
㟷	dvwh
䞼	yojp
裭	aing
㠄	dssk
蠵	ldoh
㫂	qvrz
姢	xcf
娾	xtyy
䇵	zez
橪	mzmr
䇠	zqu
僒	oawh
馟	pkrn
滝	eykd
褟	akss
䖎	sing
幨	dzth
㳯	eyb
蜰	fjl
㧊	btd
嚡	hvly
麀	qvif
炵	rxw
亱	qokt
瞣	khhe
㼞	ywtq
㷓	rfxe
爔	rwun
彺	pu
笭	zwa
㨆	bmm
䗼	litr
珢	usc
䭯	pkdd
䎌	ssho
㑋	ohv
揀	bml
㠰	fhsd
䈮	zyfh
懴	ibon
囘	dj
㴌	exj
図	hwx
㫧	kr
妰	xziy
㫐	kfff
燺	rqhm
臐	fitr
鐜	qhnn
囙	hs
陦	sbb
湴	ewp
趡	yoou
㵄	enhm
䎊	xhss
怞	il
觓	zfii
隸	mypr
玾	uki
嚜	hlyy
䅒	pvq
禂	afyh
㗀	hdcc
姎	xdm
䀠	kk
邘	tbs
䑱	fazg
苧	vat
陁	szv
粙	rl
㫩	bvk
淩	eywx
菴	vml
怌	itit
茋	vfnq
䄅	wmyp
荈	vzb
咵	hmyg
嫓	xzdf
㠵	qd
㱛	tztz
敂	fhx
㘺	yon
釐	bwxy
䞗	yobi
帡	dwv
椯	mdtd
䗟	szml
㐢	erng
燊	rrrm
㴃	eqjr
旐	qzor
㥅	irax
祹	afzd
䀎	ktg
㮹	mtcx
觡	zfxh
脦	fne
䍨	wutd
㨔	bnih
㜸	vihx
摂	bkr
䆨	awkm
泜	efnq
黙	kymr
㕶	hu
䊎	rwmg
䀲	kzjw
䃏	jkiu
㐔	qhg
淕	eywy
㑢	oycs
槆	mvfk
瘇	qity
嫅	xwuy
䗴	lzig
枼	vdm
夋	cwx
瑴	yatx
跅	jzq
缾	zbdv
䊀	rj
耛	bwch
㴵	eeil
䭆	siwc
蝩	lity
碦	jaxh
䘐	ilsw
筄	zor
㹟	psw
亸	qhnb
䶋	kltq
毘	lif
喌	hhep
㸲	bziy
窂	awb
淜	eff
矒	kvlk
魌	lcvw
熪	rpzz
辡	ybyb
韈	vlvq
䯙	gfbq
槢	mssk
拡	bqc
榀	mhhh
剴	dtho
哴	hqsc
䍟	lxdx
姲	xax
橓	mrab
焫	rvdw
粸	rvw
媖	xvdm
芆	vxq
匤	suq
㯡	mwij
㮫	mabh
㕒	twun
疅	ltlt
坒	ify
耢	bwvf
漟	epay
蚎	lk
㽞	hhl
䣲	jtcv
蝒	ltl
増	ywlk
菍	vwae
㕛	xxxx
邩	rs
䂐	zmdd
漰	edff
籘	zfwp
䊉	ram
寎	aztw
㱁	ddyw
㥗	ikq
阛	dltc
椝	mdom
斎	qoyp
㘞	hf
粐	rqj
煶	rkto
䉣	zffr
撦	bmyk
㱞	tzy
㨁	bbk
㐧	qsii
㶪	tir
尦	wofq
埥	yuf
趖	yowy
泹	ekt
箑	ztso
㱸	tzjb
䧄	sxh
籿	rb
㯮	mlfl
橸	mkkk
俙	oxbd
㞛	jpfk
黗	lyrd
鼦	frsh
潩	elvw
䏫	fom
䂁	kzhq
㱔	ofz
堐	ytyy
㛁	xyw
㢋	qozz
㜑	ebqx
槰	mxba
禐	aryx
㖅	hnit
毤	wcou
䈇	zikb
菣	vsx
烗	rqcw
熇	rqhh
䧷	xwou
䇇	ysin
䀄	aeil
䃼	ai
黆	vlwo
骮	gfn
莟	vwah
匛	szq
㑃	ocf
綔	mygp
糶	ddru
崫	djdd
噈	hqhq
俌	obq
䯊	gfth
陏	sbf
瓂	uvyl
斢	vlwb
圸	yd
卄	vvvv
㿬	ixj
冨	athl
珵	uhu
㤖	iat
䓗	vwce
㤕	idd
薭	vplb
㞖	jmd
㘄	hmlq
䏢	fix
堿	ynih
盜	ezwl
䉞	znie
䏙	fao
䏠	fy
䞘	yozg
㔻	tib
苽	vc
㚖	km
䑏	fvhu
㘡	hki
躾	idum
俋	ohj
窞	awzf
媤	xle
䕓	vazp
䒷	vij
㕉	twh
㐵	otb
鞷	thdl
噒	hrzb
䃫	jzth
俿	oing
粇	rqg
韁	vltt
禛	abkw
泧	eni
樉	mmxx
㜇	xyye
䴧	qvix
茘	vsss
蹮	jjmj
㖯	dthf
䋣	zjwp
髆	gfbb
愺	ivkb
迚	hia
殑	tzjo
貇	psc
跉	jwa
燂	rjkb
䁙	kkax
杘	jm
橬	msok
鳛	lssk
㷥	rrst
㤈	ie
焂	oixr
珒	ub
瑘	uks
㲩	ukss
䑘	fwuy
茊	vzt
洂	eqp
䦹	sb
㾸	qqhh
竁	awuu
塚	yapq
䤊	jtvk
蘎	vrfj
淴	efoe
悥	uhe
㷗	ihjr
䢅	ftyc
嬤	xqmc
狛	pk
䭫	fkwk
愂	bane
糎	rtky
筜	zps
䑨	fzv
吥	hti
㙠	szmy
豷	pyaw
殝	tzmp
烲	bzr
㺽	utit
爙	rqhc
櫒	mvzp
薿	vfzo
榏	mwwl
樶	mkkx
坁	yfn
㐈	wg
嫯	ufxx
㛰	xsik
䄚	avkk
侂	oqin
㾦	qyh
㡻	qfs
蟝	lesm
愊	ithl
虨	inmp
慻	iwmk
崑	dkif
巣	ekm
䃥	jyky
熍	rahh
䙑	aqhc
㮔	mity
戄	ikkx
㸮	bws
㼃	uchr
䍣	lrl
篧	zaou
㸋	zril
擙	bidm
䋯	qjnp
珋	ufs
渓	erm
亴	qhag
漇	epoo
䃂	jkif
豀	rhrm
䨚	rfoe
㬎	kccr
㬨	kypp
漀	yjgr
倎	odvw
霮	revd
䜴	thwx
蝍	lscs
鞪	csil
垍	yk
堨	ykfd
炰	fjr
覂	jia
奙	cml
栕	ms
硓	jyf
衏	pyoy
䗍	jpl
熖	rrf
㭐	mbw
褖	ajp
蛯	lyf
斴	rzbz
澼	ejhb
偡	ovwd
嘐	hssp
苀	vqg
䵦	lyrb
䢐	ka
宨	aor
䤁	jtvd
掅	buf
甹	ltg
撴	bqhx
硴	jvof
躥	jawr
睯	sink
莥	vpsy
菿	vtco
䐙	fvl
勓	ifkf
䙃	abyf
䇪	ztcy
傿	otor
㖁	hxbc
甝	ingv
崄	dwe
䜧	gsqo
睙	kqjm
䞎	dkk
䤓	jtvp
沄	eyc
硡	jabc
㩨	bbbe
炞	rqi
埅	sqy
跴	jj
擩	brtd
㮋	mbfs
䍿	ssu
磩	jnip
抈	bf
唹	hqww
䤆	jtzm
嵥	dzbm
敡	kfox
㮝	mrhs
䎞	yks
崝	duf
灢	ethc
窰	awrd
怲	itdw
乷	epig
宺	ahtp
㒪	wssp
䖖	ingi
䖝	il
蟢	lyhh
焸	kkr
㸝	zzw
揧	mhob
咮	hbw
稨	pqjd
㬇	kzdm
枮	mih
磎	jrcm
䙳	jr
酜	jtm
㑷	ocff
㛷	pnqx
憰	icsh
彙	jtam
媹	xfsl
狿	piog
鄚	vkms
撢	bjkb
䔪	vmxx
児	iko
䒍	eaqj
撽	bkqx
咊	hp
㬕	kawu
蟔	llyr
嫸	xwuh
鞓	vlhu
㾿	qqss
渹	efuh
㣼	isq
瀜	ethl
㦋	imyk
刉	zgo
㖭	htmp
莿	vmdo
䠽	iduw
㙍	yxxx
㐁	thw
吿	bh
㥿	ufxe
鞳	vlvh
湻	eqhk
㥣	myye
㓶	bsmo
搥	biha
沷	ebxq
㬜	tcyk
宎	aim
㖏	hky
瓽	pahq
䄧	pg
㟁	dty
䅕	pjj
堶	ybyf
㰭	mygw
籓	zeil
霚	rcsx
㙙	enpy
婍	xmth
醖	jtkl
䚚	zfbo
㥱	isou
劺	cbf
䇣	zwp
鹍	kiit
䆖	awbc
㾣	qn
鞆	vltw
樈	myko
厸	cc
䨨	riha
䢂	by
㖤	hsrd
㚃	yaxw
柇	mp
冔	dyhb
徶	prx
㼱	iyfq
恡	ixbc
瘽	qvhu
崶	dyyb
幑	pdtx
咜	haf
瘯	qqzm
挧	bss
䔎	vmha
嵓	dhhh
㑩	olz
阷	sto
渄	eouu
粴	rky
㰣	oizw
晱	krr
㣋	vqp
䓝	vnl
䏁	kayb
㟏	dwah
㹶	piyg
蕣	vrab
捝	bwj
忎	ibe
忥	ue
挴	bzjw
胑	fhw
鳉	lizb
婾	xwfc
姛	xdth
枙	mtg
邖	ds
幤	pdhd
䅇	jp
搸	bmp
䒭	vsb
䰒	upvp
㟡	dwmg
隠	srse
嬔	xzhu
䉂	zlcp
桽	mwwy
䅷	pvwm
燷	rqhp
掓	bipx
巸	sihj
㿍	qzfb
䬭	hswc
䔗	vawu
鞥	vlwv
塐	yucp
䂬	ygqj
嗕	htyb
茽	vohi
㾭	qpr
吰	hbc
㴴	ertd
㜬	xzth
峉	dxh
慜	zjwe
黫	lyry
珝	uss
㟤	dsir
䎷	kbw
狶	pxbd
楪	mvdm
榩	minq
䨤	rla
絜	bscp
戹	qjg
畁	lto
宻	axwd
䯾	upfh
䰋	upkx
蓔	vwur
檥	mwun
䎰	bwvz
㻚	uff
忬	icsi
蝵	prl
環	ultc
䉿	riwb
惵	ivdm
㗌	haty
鬌	upbf
胹	ftd
桭	mtyc
凧	gd
臞	fkku
㾐	qtzo
㣌	ihp
伭	oqc
䖱	lsu
悈	inv
䨱	rpzx
䜺	thwk
厹	gc
䇜	zzw
睼	kkto
慏	iake
嬹	xzyw
褑	aryx
獂	ptkp
鞜	vlik
吷	hsw
亐	ttgg
䍱	wuwm
㹎	blcp
䂛	jcsi
䖧	lkt
琗	uqwb
刓	yoo
栧	mkf
㲋	zhif
忇	if
㨏	bdbr
憈	iinp
㩊	brlb
屰	wd
䇱	zhx
㝋	as
洯	bsir
梔	mztj
䘦	ajf
觗	zffn
䚧	zfsp
伇	ogx
媫	xiso
䍬	wuyw
褄	atbx
檴	mvox
埛	ydwh
㝁	fkn
橞	mtke
㴫	esis
䯮	upg
㣚	pdth
欵	fzmw
㹪	pfft
㚲	xih
爋	ritf
㮠	mvam
䎧	bwyh
琍	upo
洸	epto
㲻	oir
笜	zdd
㴚	ewp
瞊	kqbh
蠜	mxxl
㣨	pxj
蟴	vwzl
葀	vbij
箶	zjf
坴	ywyy
㶓	evns
皍	kis
砿	jqc
醈	jtrr
従	pwo
捗	bop
䒟	vfq
歰	sqso
㴢	eeoi
皞	kkmb
侳	owwy
靹	vldw
嗪	hmp
䗂	ling
䅬	pwwl
㿈	qcou
㧁	qjyc
冡	atpp
匋	fzbd
雝	chju
柪	mcf
婒	xrr
箤	zqwb
㼨	wahq
㟶	dtkp
澪	erwa
䦽	scsi
蓛	vmdx
昰	kto
㞮	dzqq
㴍	esur
畯	lcwx
硶	jdwa
恷	ome
砨	jqjg
䖻	lqcp
欳	idzw
褠	avdy
䁶	kkqx
筺	zsuq
䐴	scsf
嚾	hvhu
㢞	qssw
萟	vpgq
㒈	oskx
㭮	mctz
燝	rkqp
㷚	rqht
掛	byyi
㬪	kkkt
淢	enht
霥	ratp
儾	othc
迌	fa
躠	viho
醨	jtqc
䓯	vujw
耇	yfh
隄	skto
䝦	pilp
蓷	vbou
臅	flfl
橂	mwjm
奤	mtl
㓓	wbdy
㪖	sirx
㶁	erbg
矡	csix
㓚	yo
颙	kdid
豋	zthw
唫	hn
趒	yoor
罬	lxxx
竐	ygx
蠸	lvhu
沜	ez
牸	ban
㞤	dw
啑	htso
䔳	vzmr
噽	yhwt
㮈	mmyp
㺢	prou
槉	mqzm
蹱	jyky
䐇	ffok
昞	ktdw
㛔	xxb
勂	bhf
蒵	vrcm
憏	izyp
儙	olha
榿	mdtw
礊	bkdj
徚	pml
靮	vlfq
罣	lyy
䁭	kmmm
㪦	atlx
莀	vtyc
䢴	ibs
侘	oain
㲠	bwxu
㔌	kxpo
㢰	gix
傕	oaou
蚗	lsw
㳓	ebh
䀭	kqcw
㧥	bbo
蛨	ltk
㔞	ibif
竛	ywa
盺	kz
坉	ynd
揂	bwjt
髾	uppf
㬶	fbh
㢹	gyb
㢒	qink
㭼	mirk
匷	skku
䖺	oixl
袓	ak
䊱	rwwn
䘭	atcy
㦮	nnq
㨫	bozl
睪	lywy
踒	jpx
㽂	whsq
彜	jtrv
奭	mtkk
㹘	brtd
㔰	szi
㨝	bjpf
㡝	dxba
迃	yga
哐	hsu
峲	dpo
兾	wlvw
窾	awyw
敫	kqx
峗	dztg
匄	fq
眍	ksx
蝧	lvdm
忳	ind
踄	jop
秬	pss
蔆	veyx
仏	oc
欥	kzw
䠌	jirf
棾	mmag
糫	rltc
㹣	pxw
磂	jfsl
㔕	uf
䯵	upbv
䙖	adff
袆	abs
蚅	ltg
㻻	uqhx
虓	ging
穉	pjib
㺴	um
黰	lyrw
遳	vwwa
煻	rqbh
喤	hku
梽	mye
帋	fnd
㦝	pkoe
䍓	lsii
庛	qof
聬	kwcs
䠋	jlb
㲎	uu
蒧	vnih
䈵	zwcs
篞	zeky
煠	rvdm
晍	kdth
麉	yyqf
蜐	lycf
盩	ywyl
窷	awks
㽑	vjkb
㻬	uryg
眖	kj
䎃	dyss
㹻	ppx
䢽	vwhj
䠕	jofm
䘷	ar
䒰	vsu
㭺	mml
漷	eqhs
羭	wuwo
唃	hzf
䋕	oiyp
狤	pyh
羓	wuj
嶆	dvkk
㻎	muu
萕	vqoy
汿	ecsi
庉	qnd
㫲	kban
袴	amyg
㳂	ewc
奛	mkf
塩	yzhl
㚹	xfs
畽	lity
漦	bwxr
䏎	fgq
岹	dsh
㞔	jzz
䕗	vklo
鲘	lzth
䯃	gax
䂍	csir
箘	zhp
䈰	zbpf
㐛	obhg
䥻	ntn
㙲	yqcu
霬	rlvw
斈	qn
乚	dddd
挘	bpif
偓	ojty
䂈	csil
燓	mxxr
㐩	vv
渨	eltc
㔹	bf
庤	qyb
䉪	zlll
迣	vda
㖊	hsb
㢄	qthw
摍	baok
嬶	xklo
蠋	llfl
瓀	urtd
䢫	sbya
氜	uk
怤	obe
㖸	hint
汣	ezq
祴	anv
洐	epy
䵍	vlwn
簳	zbky
弲	ghf
㝠	ake
篺	zblb
飸	htgc
皃	ko
蔲	vayx
㜚	xaok
虶	ltb
虝	ingo
䪀	vlae
㧒	baw
脝	fqhs
㜽	cn
歭	oyb
猣	pxdx
嵟	dtou
䕌	vpou
悺	iah
㥒	irm
桖	mil
乣	cd
枔	mwa
瑆	ukiu
垱	yps
㥀	ibk
蛣	lyh
虤	ingg
腶	fzux
㒽	dywg
㭋	mb
莚	viog
揙	bqjd
曕	kzth
奺	xzq
䯑	gfpo
疈	thll
㳜	eom
莾	vmbv
䕅	vxfx
㸹	brb
䁠	kwsp
獌	pklx
奒	mqcw
揵	bbg
聁	kws
㲨	vku
戫	bfnt
觘	zfpi
槗	mbhh
靁	rlll
蕌	vkkk
厔	ttcy
凊	wuf
䌹	cdh
㭧	fm
嵦	ddtw
㭙	myb
歑	iniw
巕	dwin
恾	ivq
㗯	ykhf
肎	afff
㲕	rbu
昷	klll
敐	tycx
䄽	pj
疪	qif
唴	hwud
旙	qirl
㛄	xqc
搇	bwac
娡	xye
蛚	ltzo
蓗	vpyo
昁	ktd
劯	jf
㶜	ejwo
㤜	iniq
㑖	oohi
棅	mps
凒	wdtw
㢑	qoub
裑	aidi
荍	viix
䁆	kml
婰	xdvw
㶣	yr
䢯	rrza
㚟	zhim
癨	qrou
㜀	xmk
聈	kcf
蛂	lbxq
抾	byc
䈐	zibr
羒	wuws
稵	pwcc
腃	fwmg
芿	vog
愬	wdfe
楕	mbyf
砓	jgx
䯠	gfkl
鄈	ztms
㑤	ovl
玙	utgt
䘰	aiog
㽣	lnht
乬	ssg
杍	mn
垪	ywv
㑈	onp
柼	maw
㷈	rml
獚	pvlw
痟	qpf
㜐	xdtw
䓎	vrfq
礭	jrou
䇉	yj
棬	mwmg
䈦	zxdx
䅲	pyfk
忺	izw
䵝	lyrd
聓	ygqk
玐	uw
䀝	kif
迱	afa
烞	rmi
㛦	xmm
窔	awex
摎	bssp
踨	jwwo
壌	yevc
硊	jztg
隑	sdtw
䇀	awvk
砅	jir
岦	dy
䓹	vwqc
䉼	rz
敼	yhwx
琾	ulwo
廆	qlc
㙆	yabc
䘗	pdty
氃	ykyu
姫	xs
䣭	jtm
焔	rzik
椶	mxdx
㖜	qhhf
筣	zpo
䥚	gkkn
㺖	pskx
㨳	bamh
杫	mo
峁	dfs
扆	qjqc
擔	bzth
滼	emmq
䩲	vlqx
䂤	job
亃	rzbd
䩕	vlfs
腨	fdtd
㸵	byh
畡	lqcw
翑	ssfh
䆤	awii
埿	ejfy
䣷	jtbw
妬	xj
慤	yage
㛣	xhd
瑉	usik
妌	xv
涬	eywy
㣠	pixw
㩾	itvx
㓎	wsax
熫	rqvr
仾	otjt
妿	fhx
㵊	ekkx
㘥	hrzp
実	am
㘒	pitf
哌	hzc
楿	mpk
準	eoub
榵	mvk
㻿	ulfl
惪	bke
鬴	thdq
笻	zys
䟩	jyc
礶	jvhu
捊	brn
㹛	btkx
觢	bszf
麠	qvit
㚭	xnq
䁎	kqht
㫺	wwwk
蔤	vaed
䔤	vktk
䯻	upbh
䣁	sss
遫	mhxa
蹜	jaok
丅	tttt
宱	aozy
䯫	kqhh
笩	zon
偫	opyb
峺	dtkx
楧	mvdm
踶	jkto
㳳	ejo
䀒	kib
暏	kyk
汻	ezb
厯	tmmq
㣄	gesm
䐏	fmk
㓗	wbsp
䐀	fmth
葂	vzhf
䩒	vltb
烿	rfqp
冘	aooo
溿	elwb
㹭	pkf
夳	my
㵛	ewuh
䔒	vsyh
挱	bepi
㽱	qii
炧	rzv
凪	go
粧	rqy
㟌	dnpq
琒	uxb
屻	dsq
凣	ig
㶱	rmt
壻	ysof
勨	zhpf
嶯	dhkn
毠	fhu
阥	sir
瘧	qint
鹖	kfwt
䣥	jtf
㛀	xzs
䅤	pibf
㟘	dfyh
溛	eawc
㗦	hkfs
辷	ta
禿	po
枦	mqj
歾	tzfo
溬	ewuc
箊	zqww
璤	utke
搯	brf
啈	hywy
㓞	bsss
阞	sf
䪣	bdit
璘	urzb
䥌	akkn
鹱	gtvx
苖	vl
墄	ynip
䣊	pdhs
䟻	jwm
琀	uwah
圗	hcbl
浕	ejqw
垴	yqxd
蜳	lqhn
鄝	ssws
䟲	jqco
玿	ush
䙄	aibf
粁	rib
䆝	awil
觱	nitf
噄	hbsp
枃	mfw
㝆	nyhh
䧚	sqhh
㗃	hsik
㳼	nhtr
㺄	pwfo
峏	dtd
溍	etpk
粊	ifr
阺	sfnq
冑	ldy
逎	jta
䊒	rou
昻	kys
対	qb
塓	yake
婖	xtmp
䘨	aex
惣	bfoe
䞦	yoxh
㻀	ukx
簶	zasr
㓽	dayo
朚	qkf
䊆	fr
螷	qlbl
毷	dyku
劷	wuf
稱	prdy
䟗	jfn
鼫	frj
牭	bho
棙	mqjm
嵑	dkfd
嚤	hqmb
苳	vxw
翚	ssab
籸	rgb
㔁	ztho
㥛	isht
乺	zszg
㓪	qscs
睓	kdvw
蔙	vqzo
悀	icf
伻	oyw
貏	plb
佋	osh
蜪	lfzd
蘲	vlly
岮	daf
㢧	gt
舙	ijij
熑	rwsp
蹫	jcsh
䔆	vpky
弐	tyn
㠾	zgd
斮	vkz
伃	ocsi
㻣	uvwd
脳	fexd
遝	lira
膫	fmkp
跔	jfh
䃅	jwkb
䪪	fhyk
孴	nnnk
蹹	jwhs
孈	xdoh
嗈	hchj
䓸	vxxy
榒	mgww
汫	ev
䰙	thdx
壄	mcsy
孮	nayp
㘷	yvx
韸	ykxb
㸣	zpww
趀	yoii
铏	ntvo
崣	dpx
䄍	avk
酔	jtgb
醂	jtmm
㷬	rvkm
喹	hmyy
艒	fdyk
埀	itiy
㵁	evqp
骺	gfzh
孊	xqmu
塝	yeaq
䗔	losm
䓦	vdvw
䞸	yoyh
㟪	dltc
瞃	kzbk
㡯	qin
鼺	frll
筿	zxm
䌽	crm
䵿	yhwh
況	ej
烐	rf
堭	yku
䛚	bsuh
毩	ur
㸒	riy
㘫	yv
蔋	veix
虯	lii
㑬	oxj
䞔	ypju
䜱	rhkx
赺	yowa
藌	vael
䕫	vkox
麎	qvic
瓸	tigk
㥸	sine
㳙	ecf
酰	jtbo
幒	dhxe
熤	rssy
儑	okcr
牊	zsh
嵭	deaq
泘	eiwb
筀	zyy
㓅	wt
㿸	ixkx
躤	jvbk
塳	yxba
篭	zykd
㡔	csid
朏	fdd
䁥	ksvh
䵭	lyrk
栞	yym
藟	vlll
浌	eon
䦶	dzsi
䊩	rirl
亷	yisp
㳫	irf
㠧	dqmu
䐜	fbkw
㽢	lml
勅	mhf
谼	rhvw
箛	znc
猄	pqhp
鹟	wcst
䎆	sswa
滪	ecsd
㕆	tj
豂	rhsp
墭	ynfl
踀	jho
媢	xdyk
彾	pwa
卭	ys
㷐	rfy
埍	yhf
㚿	xfj
䩩	vlag
㤊	ixx
椬	mak
噡	hzth
菢	vbfj
佦	oj
湌	ewqc
髜	qhdv
䙶	jac
䩠	vlig
䟼	jton
雓	wmou
髬	uptt
呫	hih
㘾	yatb
㗝	hwur
曡	kkkk
怮	icf
畕	ll
荮	vcb
蔔	vftl
澲	epww
湅	eml
恅	iyf
僿	oavy
䊠	scsr
㗔	hinq
䶅	frxh
苬	vhw
犉	bqhn
脢	fzjw
㳢	eimo
罞	lcsi
䊔	rvdm
嵲	dkm
毾	kssu
胿	fyy
䩭	vlmh
劥	qgf
嫇	xake
㿿	sol
惾	ixdx
䂹	jzr
勯	qhhf
䴥	qvih
赟	qtod
䒚	vpi
䰠	lcki
㚀	yinn
哛	hfws
郘	hhs
趶	jtb
㧵	btih
魐	lcwp
狌	piu
箃	zkx
旳	kfq
剹	sswo
踛	jywy
埩	yzsi
岒	dwa
舲	fwa
荄	vqcw
囸	hto
䌿	cthl
埱	yipx
甃	prtq
㖠	hmyp
㞥	dw
㡈	dzho
芞	vu
崹	dead
㖩	hkx
剣	whwo
㘈	hfzo
敇	mdx
裛	qhjc
狕	pcf
䃋	jwfo
圼	ky
朹	mg
椻	mskx
䅺	pjyp
褩	fgxc
㞷	du
柷	mj
儛	ozvb
塮	yidb
㗨	szmh
䏋	bwej
剰	pvo
禗	ale
缿	zbdh
侼	oban
懥	ibao
耞	bwfh
埢	ywmg
菾	vtmp
㤨	ivw
倞	oqhp
疭	qww
㚪	xu
犦	bkvr
渼	ewum
㳘	eqco
胠	fyc
姳	xzh
㲬	ouru
磳	jwlk
㯾	mvka
叚	jysx
㷭	xbar
㫕	kto
㷟	riha
扵	bww
㱟	tzix
䕢	vjwy
㜴	xvlk
㲣	fixu
㾕	qyb
㤵	nxe
㻑	upn
蒠	vke
䞝	youq
䵣	lyrt
歖	yhww
梴	miog
疛	qb
㑥	okfo
㤙	hse
禌	awcc
瑠	ufsl
䉾	iyfr
豯	prcm
槦	mqbf
㗺	htmu
䗷	lyke
甕	qcoq
楖	mscs
畄	el
㑐	oip
㠹	dwo
㝳	mqqq
㻋	umh
䑣	fp
㱐	yoqq
䈋	zirk
秏	pu
狧	pij
剫	qvxo
㿥	kaou
鲯	lvw
㞉	nwuy
倹	owhw
䶭	bfqu
獽	pqhc
胒	fjf
槴	mqjj
曘	krtd
倰	oywx
飱	tzwc
㱩	tzym
仈	ow
鬑	upwp
嶓	dirl
䧀	sbc
齆	kltj
涾	eirk
䀻	kltg
黓	lyrn
惔	irr
䯝	gfbf
袟	aim
㵹	edvm
㜃	xouh
㖻	hcsm
蔧	vbbs
熃	csir
髳	upci
噐	hhyh
屾	dd
堔	yawm
僜	oztw
䓓	vbb
㑿	ockm
䰧	lcig
稌	pwm
斊	qk
珴	uibn
帓	dbw
挏	bdth
倻	oks
髩	upts
㫉	qztg
㐱	wppp
䧳	oou
庒	qyq
䏦	fij
犝	byky
㚼	xl
籵	rb
椩	mqsw
圴	yfq
㳽	egzp
蕛	vpwi
㱅	yatw
骪	gfgq
婛	xqhp
㜆	xra
㦧	ibok
坖	yoy
塄	ylq
薐	vpyx
釈	irjq
㗱	houm
襋	amdd
躹	idur
㪸	vwwb
遈	ktoa
萚	vbxb
㥊	iff
擮	bbon
夣	qclz
郌	yyhj
盳	kq
垿	yqci
旔	qbg
窢	awnt
㾃	qaf
踍	jyn
瓃	ulll
䒻	vdj
㿰	exix
俻	oxl
涐	eibn
跭	jxb
瘖	qyk
俈	obh
扟	bgb
猏	pqjf
㞗	jbrq
帥	ihd
瘄	qvk
缻	zbdq
剙	wvsw
趇	yoy
㴹	era
刼	ycsq
鲌	lk
蒾	vra
䰪	rwfc
㯏	yjgm
㮂	kwm
䝚	pjf
幉	dvdm
㼩	nftq
煗	rtdm
臸	tcyy
㝗	aqsc
皫	kqvr
堟	yjp
蚢	lqg
㼚	qgtq
馚	pkws
庣	qor
竷	ykbx
㠑	dlou
剆	qsco
僣	ommk
熐	rake
㔛	yhf
㿞	ku
髷	uphv
皵	vkix
葇	vcsm
猼	pbqb
崯	dn
螧	lyfk
蚽	ltit
燩	rkqx
僱	oqju
醿	jtqp
廘	qqvf
娖	xho
㤶	inpq
仹	ob
儊	ommo
獓	pufx
㦕	isxu
蟏	lvbw
朡	fxdx
椾	mwfo
鄐	qcls
琣	uyh
娺	xxxx
㲙	uqcp
捼	bpx
葔	vosm
㫜	kkt
笍	zdw
潥	ejr
拸	bzz
鲝	wul
秴	pwh
睧	kfnk
価	oj
蓭	vqml
屟	jvdm
巌	detx
倧	oayp
㨮	bkfo
㹊	baou
㨉	bsik
䓁	vyb
嚗	hkvr
秖	pfn
㫪	mik
勡	jypf
煡	rbg
蹎	jbkw
禣	abqb
㧩	bgtd
笘	zih
袹	atk
碿	jjpf
䘌	svbl
㮺	mthh
睰	kvbh
惍	in
㕡	iatx
㽼	qgi
咠	hkkk
䏸	fuh
㮳	mfwm
岠	dss
蓞	vrf
僺	ohhm
䟟	zqho
倗	off
禥	avwy
喕	htl
䟠	jni
㥩	iyk
㢳	gzc
竅	awkx
䞷	yojd
秈	pd
䄐	ddyj
鲏	lix
祑	aim
䈻	zfbq
禉	awjt
傝	okss
㵥	eael
瑎	uifk
獳	prtd
蠰	lqhc
嫾	xrzb
壎	yitr
㕳	hxd
㖇	htd
䏿	qjxf
䈚	zche
褾	ajyp
㫇	qwws
捠	bztw
㕺	hhtg
兛	joib
㝩	aqbr
㕪	hao
旡	sooo
逩	mbva
牏	zwfo
怐	ifh
僎	ojjw
䧨	spww
䞮	yowm
㚚	mzh
蚐	lfw
酛	jtyo
哹	hrn
䄁	avd
镻	uim
橦	myky
蔾	vpfm
簉	zbha
彆	rxg
㧎	bsii
糣	rsok
簒	zkmc
圦	yw
樎	maok
㒶	wk
㞺	dzm
婹	xjx
㔒	douo
皚	kdtw
奧	idim
柈	mwb
迉	ja
䂖	tqh
䩇	tlih
夆	xbbb
穓	plvw
䈩	zweo
袌	qfjc
秝	pp
徳	pble
茟	vb
㨠	bake
淥	ejtr
売	yao
磗	jbqb
㡇	dkd
裮	akk
卬	fs
㫣	kl
旼	kq
嚥	hvhr
㽏	ewhv
㱽	aogx
竔	yiv
祽	aqwb
㴕	evp
挌	bxh
奰	lllm
䙠	atww
阬	sqg
嚊	hklo
峖	dax
鼴	frsx
跐	hof
㔭	dtko
囯	hu
稺	pjyb
䀤	zik
荴	vbm
袨	aqc
㟯	daxh
逘	czma
䄳	po
㰘	mjtv
㼿	ykyq
㠭	yyyy
㡎	dcmp
忋	isd
嬆	xwhs
迬	qua
㧻	bpq
璻	ussb
聙	kuf
䅻	pqxc
寘	abkw
䧤	spwm
烶	riyg
渵	evl
㓱	wfoo
㰱	ibkw
礿	afq
儽	ollp
褧	krqc
婑	xpx
梐	mify
玊	uq
䬩	tiwc
鞩	vlpo
沎	eof
鞮	vlko
㟓	dxbd
嘒	hbbs
熮	rssp
媄	xwum
玸	ufj
渀	embv
䎳	kf
籇	zqhp
㧼	buc
䀮	kqp
芺	vim
㲒	fhu
䅥	pkfd
㓙	qd
氉	hhhu
杊	mp
㥞	iwp
邲	eis
䇔	qhfq
帪	dtyc
㲀	tycx
㣏	mkbp
蹵	qhpo
㻺	tppq
憐	irzb
郱	wvs
䥢	yhwn
靺	vlbw
粠	rvw
刲	yyo
砆	jm
琌	udwa
錃	eixn
㠛	dvox
曻	kzb
㐏	ug
㖓	hxb
峈	dxh
嶏	dtjd
䎣	bwiw
䒱	vsrt
旪	kb
沢	ejq
䎡	tdr
㔐	ztoo
㓠	iho
聠	kwv
奞	mou
柭	mbxq
䨞	rild
峩	dibn
穱	prlb
鸼	fgt
蚔	lfn
㵮	emvl
䂑	zmof
搃	bwhe
㸼	bxb
漘	etyf
疄	lrzb
忂	pkku
妸	xth
壡	iaty
䪰	ykye
惸	ifkn
摮	ufxb
荖	vyf
㴞	erik
沠	er
穂	ptle
穞	plk
攼	yx
彛	srwv
甽	lp
籏	zqzw
峷	dyb
㻇	uwu
䆗	awhi
豠	pk
䏅	kzyp
䂰	jpo
霅	ruh
瞆	kld
䨵	rejb
䂭	jex
䃷	jqhq
䆩	awkm
㴦	eahh
㪇	box
甤	piu
墛	yjyb
㭳	myn
耴	kd
畇	lfw
憄	pbke
夑	uhrx
㶼	rczm
腜	fvm
㖲	xhhf
刟	sho
涁	emp
䍁	cwpa
巈	dvlr
伩	oq
㚸	xsth
㝿	nix
㽧	lwcc
䍭	wujw
嶶	dpdx
䆢	awbw
㴯	effk
㲏	zu
䨾	qouu
㗈	hcff
䠲	idua
䘢	aat
焽	kfr
䨡	rsrd
膔	fqvf
䂟	fhj
㩃	bavw
㣞	pwco
蒊	voff
䑉	fqhq
涢	ehd
笴	zth
尳	ngf
疧	qfn
㛵	xrdy
硢	jwm
慠	iufx
礎	jmmo
㭶	mvq
祶	awgi
欛	mrvf
酼	jtqp
篶	ztor
鲾	lthl
䑓	vaty
躄	jhyo
稶	pnhp
戺	qjj
慛	idou
澭	eqcu
䨬	remm
牳	bjw
㟀	pd
㚦	xto
䖬	lki
㰧	chzw
㬖	kqjh
蕰	vekl
㚑	sm
㨋	byk
椄	myx
䠙	jeaq
㟅	dxdo
襚	awpa
潉	edkf
婟	xhj
牤	bq
璌	uatw
忈	ye
䁋	kvdm
䖏	infx
戉	ni
䐥	fwcs
㩆	bqhq
憺	izth
㳅	eti
䯲	upj
姃	xto
艈	fqcp
沗	tmir
㓣	who
䀑	kxq
瀼	eqhc
廂	qmk
蟩	ltww
蹗	jqvf
褀	avw
㮐	mpik
谹	rhbc
㭂	mp
祣	azc
墺	yidm
霙	rvdm
豲	ptkp
䁕	ksik
枿	mbv
澚	eidg
遞	zina
霌	rfyh
勏	yhf
坸	yfh
烅	ril
䖤	zgl
㔿	tiii
䑜	ijvm
儦	oqvr
鞗	oixl
㷡	kssr
䧏	sxb
鼏	akzz
淰	ewae
磥	jlcp
殣	tzvu
㒦	olly
篣	zeaq
眬	kbfq
嫼	xlyr
㩑	btmu
䒑	wwww
珖	upto
榋	msss
氂	bwxu
癏	qltc
霠	rywa
汚	ettg
䯎	gfwy
䣮	jtbq
桜	mex
㐄	bbbb
墬	sjpy
㴉	eccy
尒	wp
酭	jtbf
舠	fs
糒	rvif
硆	jwh
澥	ezfb
嬬	xrtd
旈	qqcp
洍	esii
迾	tzoa
㴒	eqpv
烣	rbr
趎	yobw
抭	bag
嘋	hynx
踫	jwp
殕	tzyh
䧺	bhou
悩	iexd
㾴	qmk
䜆	qmmh
㸙	wxyk
㰆	thim
漴	edap
吚	hsi
㢇	quh
嫳	rxx
㸪	bp
霫	rssk
峛	dtzo
兦	wd
夈	xr
䄦	ps
㱢	tzqc
㛐	xtkx
牁	zth
瀽	eavo
灳	fr
磜	jzyp
䙯	anio
澓	epzx
坿	yob
㺹	ucv
䗚	lbqb
劽	tzof
㬊	kryx
坅	ywa
㯳	mvfx
脙	fbrq
貖	pwwl
蛗	ihl
愰	ikpo
镅	njk
栴	mzfq
崕	dtyy
堘	ywmy
烄	rex
奌	ihm
㰪	yyzw
彵	pv
㛿	xvad
㬃	kchr
㾻	qswm
䆷	awch
䓏	vtih
䚜	zflb
筪	zski
䤘	jtwn
鐅	rxn
嬠	xhhm
䔮	vvwz
䠢	vlao
暼	rxk
坱	ydm
嵆	pnqd
㩹	bllk
䅋	pzho
蝺	lild
㛼	xibf
汏	em
婲	xvof
洖	ehtm
玓	ufq
榃	mml
昽	kbfq
塈	scsy
䠫	jkxp
㥬	ieaq
窴	awbw
殅	tziu
蜙	lmwc
㠤	dqhc
渇	ekff
腵	fjyx
恖	hxe
螉	lwcs
脮	frx
骦	grmk
㲈	yjgh
稤	pqhp
眧	ksh
䔉	vpp
咃	hov
䃡	jsok
陗	spf
䢌	tda
㭚	mzc
軅	iduu
㪪	tmox
迒	qga
焴	rqcf
㨼	lxhb
岾	dih
㰟	uzw
䤂	jtvm
薞	vtzc
䤏	jtob
沴	ewp
蜔	lfl
枈	ifm
洈	eztg
䧝	sdtl
凕	wake
嚁	hssu
㿔	qlll
晽	kmm
甶	il
鼞	yhwy
褵	aqxc
㮙	mhhg
㕦	hmmm
烒	rny
磓	jiha
眕	kwp
䒿	vaf
焑	rhm
㾞	qjt
蘮	vlto
硁	jcy
䜨	ghhe
薙	vzmu
咍	hch
蛅	lih
㛉	xj
鹋	vlgt
洢	eosi
巟	qppp
屆	jyd
氼	irw
㮇	mtmp
悡	poe
廹	kg
涳	eawy
洔	eyb
唽	hmz
㔙	wvf
殽	xbfx
㣬	phk
昐	kws
凜	wqhp
㳐	emd
㠒	djyo
蟐	lpad
殸	yjgx
偐	oyip
俇	opu
㐮	evc
謽	ghlh
㡘	dwsp
艥	fhkn
粔	rss
䢞	mma
㤃	iq
乨	chd
俰	oph
䇢	zj
浾	eyp
䑮	fgm
晭	kfyh
䘄	ykll
羏	wup
陖	scwx
俢	oxp
嵛	dwfo
馦	pkwp
凎	wn
㴈	eztd
聅	kzm
䒴	vbf
湂	ehhg
瓹	hftq
㜝	xwat
疦	qsw
盓	etbl
䦉	uho
㭌	mb
㵀	eqzm
悾	iawy
堾	ymk
姧	xxy
焇	rpf
獕	pdou
掦	bkfo
葠	vosx
䦺	st
刄	sq
䕸	vlyh
垗	yor
伷	ol
瘈	qbsm
㭜	mnb
㪅	tdwx
玧	uco
㝾	nby
䁀	kbz
䑕	fgb
㒴	wdd
眾	loww
㥎	pfie
㤼	iycf
㜹	xkku
㹦	psh
羘	fwu
㡳	qfn
黊	vlwy
薣	vyhx
䓙	vibf
䠇	jjdd
㞐	jy
㞂	nrx
庨	qyn
甪	if
䁜	kkpo
歞	kccw
㙭	ytww
蝞	ljk
㜌	yatx
䵚	pwif
䢹	sss
蓪	vcfa
嶊	dbou
溇	erx
㑗	oidi
㝮	addx
衠	pbky
偗	opik
茿	vygq
匒	fvwh
粭	rwh
㴀	evia
勽	fw
鏧	yjgn
䵪	lyrf
䲞	lyv
弾	gekb
䄉	aibn
瑥	ukl
䕈	vzvm
墖	ywhl
姕	ofx
㑉	ogtz
瘚	qwdw
㤠	tzoe
幎	dake
䅙	pkif
㐠	rndg
矀	kpdx
晇	kmyg
㐼	oiv
䎁	jss
菫	vthu
虙	inei
睳	kmyy
葎	vpb
椖	mqjq
垟	ywu
䍴	wupx
嫞	xqbf
婤	xfyh
堉	yqcf
骳	gfix
哸	hrx
滱	eayx
䜾	thwk
㦤	yate
屵	dttt
㭇	mco
㚣	xx
㼶	wfoq
㱼	sigx
㪯	qb
稁	qhap
晐	kqcw
㛢	xpg
蒆	vygx
珆	uch
㺋	pwcs
肑	ffq
鲆	lyw
咘	hbd
㞠	jmkp
㵲	ezvb
姵	xgtd
䁿	lyrk
猰	pbsm
虠	exig
䢕	nita
袦	add
猔	payp
挆	bgm
䄹	pwib
黮	lyrd
䃔	jahh
蝬	lxdx
㙛	ybqb
魖	lcip
抧	bhw
逴	ikba
毄	bkhx
粋	rgb
㪚	vkx
䓊	vuh
䇍	yho
槚	mjd
漻	essp
䇼	zhj
焢	rawy
楛	mvj
柋	onm
䈔	zjyx
㘏	wkaf
躳	iduh
㤯	idwh
㙵	yqhy
曑	kkkp
呁	hfw
䘓	ilzf
琺	ueyc
㑄	ojw
㹃	ouub
豟	pqjg
豘	pnd
䑬	for
炇	rx
獇	pwuc
滖	eqhc
㜯	xsir
灗	elqt
㰃	mkdp
淒	etbx
啌	hawy
簷	zzth
玌	ud
㭕	myc
踤	jqwb
㶎	elta
䛒	ytgh
舋	zydk
䏀	kmho
梛	msbs
㽕	lsg
䉋	zxjk
徎	phu
咾	hyf
捓	bsis
庺	qwcm
筶	zbh
㧖	bqjg
怉	ifj
㡁	dmyg
㻞	uqjd
庿	qvl
䐊	fkif
㧠	bcp
㹷	xbdm
玜	uwc
㶗	zjwr
苝	viyf
㝜	avk
妱	xsh
㧅	bs
㲿	eq
䓫	vmth
臽	zfff
廍	qyhs
抏	byo
媙	xnix
欩	shzw
㻰	ubbs
钑	ngq
㾌	qbo
䚫	kqxf
啣	hzts
䣽	zmht
衳	awc
抁	bco
垉	yfj
皬	krou
搢	btpk
樕	mmhw
㲭	rrru
喨	hqhg
䐧	fqhh
䒇	fatl
䝓	pchr
廏	qkfx
簓	zfyp
啚	hbhh
豏	thwp
厪	tvhu
翍	ssix
薼	vqvy
硔	jvw
岆	dim
㶯	rfs
靵	vlsy
媿	xlc
掟	bato
竰	ytky
滈	eqhh
憞	iqhx
勚	vddf
嵅	dnih
䨓	rhh
摷	bckm
媋	xmk
偂	owfo
㬈	kkl
昢	kdd
釄	jtqu
袳	azz
戵	kkon
拺	bmd
䖈	inf
療	qmkp
㬤	kkcr
腇	fpx
㨷	bvhu
䖡	lsy
䁒	khk
㼤	bstq
岧	dsh
檓	mfyx
竻	zf
勬	wmcf
㱳	vkmz
䅠	pkto
渏	emth
㨩	bqig
䖵	ll
硰	epij
䐰	foif
䍚	lqsc
蛬	vwl
䵑	pwiq
㝒	aj
乶	bqg
搙	btyb
俕	oam
趝	yowe
虲	li
艍	fjj
㭨	msis
㼑	mlc
㪓	ibix
摠	bhxe
稓	pvk
佌	oof
乭	jg
礡	jvbb
琞	kfuq
莤	vjt
癁	qpzx
䙈	aosm
㬽	fhhg
墈	yvwf
垐	wzwy
㪌	cfix
啍	hqhn
肞	fqx
璱	uuui
蓅	veqp
㪡	abhx
眱	kmg
㞱	dk
唋	hwm
屒	jtyc
揕	bvwd
幍	drf
齃	kltd
姌	xdy
䦀	nssv
瓝	cfq
猑	pkif
麅	qvij
傮	ovkk
猵	pqjd
饏	skxc
䖿	pfil
鞌	axvl
笢	zsin
㝀	jwn
㟥	dcmp
䍌	zbdh
䀩	kxh
伌	otg
蒦	voux
竍	yb
硾	jity
蛧	ldxx
䕦	vqhq
砈	jtg
䠐	jkm
䘾	aah
唙	hpr
裧	arr
䉥	zbhe
㬡	krwa
趤	yoaj
窻	awhe
冃	dy
㹔	btlt
㩖	btlt
䔷	vuua
晙	kcwx
峮	dsih
盦	wajl
㬯	kqhq
侸	othw
㺰	utd
眛	kbw
䝠	ptkp
㦇	iqvf
儃	oqht
䪟	tdxt
䆄	pqht
汃	ew
鬂	upzw
畳	lak
㶽	rhdw
伾	otit
睋	kibn
㦚	ybeb
棨	qjxm
厼	cp
㩤	bbqx
䖾	layo
㬲	tkxl
煄	rity
箺	zmk
挕	bk
㦙	ikde
澁	eooo
迀	ya
昫	kfh
㡡	dttb
䰆	upcm
䠏	jztm
菈	vby
唕	hkb
䞫	yosh
蚹	lob
螰	lqvf
偹	oixl
亖	yy
鍫	prn
䓠	virk
䈴	zwsp
躟	jqhc
缷	zbds
磃	jzig
䏳	fbz
䟤	jei
㶞	ekqc
禟	aqbh
䏖	fgi
峳	doix
䞳	yoyh
䗊	lrr
捴	bwce
梾	mtr
崪	dqwb
膄	ffix
䟣	jmq
蟉	lssp
懍	iqhp
伜	ogb
䞴	yofh
煝	rjk
㽁	tppq
粰	rrn
䕧	vgfx
睌	kzho
嗼	hvkm
䎨	bwml
䔝	vofp
橑	mmkp
䟒	yovu
蒨	vouf
㧦	bfk
䰣	lcdx
傛	oarh
仌	wwww
琘	ufnk
敪	xxxx
㼥	ytgq
蔝	vkr
䅃	ygqp
嚭	yhwh
侢	oud
蔃	vghl
祕	aei
摛	bqxc
収	iix
㯰	mlbk
黚	lyrv
槈	mtyb
矠	csik
悎	ibh
艌	fwae
胦	fdm
奾	xd
䄮	pm
稴	pwsp
笿	zxh
傄	omk
袗	awp
莁	vyww
馧	pkkl
衴	aao
襒	arx
檖	mwpa
笣	zfj
秛	pix
㮉	momw
捘	bcwx
䊫	rlou
䎼	ksir
阧	swn
㢯	gsin
杦	mzq
蛕	lbf
塯	yfsl
㨅	bvdw
䗪	qvrl
竚	yat
湊	emtm
秢	pwa
㦌	uuue
秠	ptit
㔡	hxif
禑	akdq
㹱	pho
犳	pfq
㧂	qjl
漺	emxx
燿	rssu
彁	gthh
㠌	dvww
糬	rlyk
槺	mqbr
悇	iwm
朼	mf
䞐	dmk
㠫	ygqm
㫓	kzg
挅	bgm
䎍	ssbq
㫡	kxw
㕥	hw
萶	vmk
䀪	kpy
䅑	prx
䏪	fk
㧓	bc
㒀	oedj
皠	kdou
㒉	opam
䩋	tlqm
惙	ixxx
䇌	ypf
㕮	hwx
㫦	oixk
尮	ngm
秔	pqg
陮	sou
㽔	ppiu
糐	rbqb
㕾	phf
㹄	blwx
䜹	thwh
勈	cff
醩	jtvk
萠	vff
磌	jbkw
斨	zz
彫	fyhp
跧	jwu
箳	zjwv
䎖	wlks
㮀	msrd
韴	yktd
禃	abk
䟚	jyo
岪	dgo
藦	vqmb
㣰	pire
㼖	cjpl
娿	sthx
㫚	fok
菬	vesh
敳	dthx
葮	vzux
㞡	jyyc
䁈	qjxk
䑲	fikb
亾	wd
爕	uhrr
麆	qvik
溁	evam
葋	vffh
瓍	usba
䒧	vyc
啽	hwhv
蓶	vhou
觩	zfbq
盢	lml
竫	yzsi
跍	jj
粿	rkm
㷒	rkdq
嚒	hqmc
蒖	vbkw
攂	blll
込	wa
祬	atcy
㻩	uwsp
㾤	qawy
㟿	dvmv
䈃	zesh
㚄	yalo
㕷	hk
睻	katt
亰	qkp
袡	ady
旊	qztq
笀	zq
鹐	zfgt
岅	dzx
㾀	qyc
熺	ryhh
䀃	pl
䞏	dle
瑬	eqcq
䶎	klth
㚰	xtit
歬	of
寖	aesx
姪	xtcy
甉	wspq
岓	dz
㜙	xqvf
筟	zrn
朖	fqsc
猤	pztm
㠽	dxw
䗧	lqbr
㢀	qmd
㨱	bzuh
㤬	iyy
叡	iatx
珻	uzjw
窅	awk
瑅	ukto
㿫	ifix
䄼	pthw
䯔	gfan
㮸	mwma
夁	ylhj
㐽	ogx
樛	mssp
㑅	ozi
芢	voy
㒲	wk
曔	kvfx
烳	rbq
媥	xqjd
䆠	aws
厃	zttt
陒	sztg
苾	vei
摱	bklx
篴	zpa
媗	xatt
䒸	vil
焃	ryp
㮱	mvbo
腈	fuf
㩬	binn
㸱	bzv
㺉	yatx
圿	ywo
㗬	pahz
裃	aitq
㯩	xxxg
嫄	xtkp
䰄	uple
泦	ejg
䧭	shre
湑	esof
凷	yd
猲	pkfd
棝	mhj
暓	csik
㑓	ocbx
鹴	rmkt
歂	dtdw
嶅	ufxd
㤝	iqco
䧟	srf
㳔	exb
㨓	bawb
碕	jmth
扂	qjih
笒	zwa
鄵	hhhs
痀	qfh
觛	zfkt
祿	ajtr
㻼	ujkb
痐	qhh
堬	ywfo
愯	ioux
覄	jom
踲	jzbk
権	mzbu
㖄	hep
犆	bbk
楏	mmyy
禭	awpa
䝀	thwl
噊	hcsh
楡	mwfc
齂	kltr
䏨	fih
犘	qmmb
梀	mmh
㗚	hjm
㐐	xxg
髰	upvd
䀆	btrl
泟	eto
㲮	uzwh
琻	un
䗱	lpwm
黅	vlwa
揷	bibf
迋	ua
獥	pkqx
㐉	tg
潡	eqhx
忹	iu
㦱	tyn
㙏	yzkx
胏	figi
弸	gff
䃗	jsio
䞙	yotd
氋	vatu
㦲	bfn
挀	bzc
䏡	fyp
䧅	smg
踗	jwae
圷	ytq
渿	emyp
枽	bvm
㳹	emu
䕋	vyqh
䉫	zpfr
瘏	qyk
䀷	kycf
㹧	pdm
䏟	fei
蜯	lmb
䞢	yozy
㐜	brqg
㛕	xhj
梒	mwah
㗾	hvlf
疩	qgb
苊	vtg
䘂	lbon
氄	csiu
暞	kkm
氒	fnb
姺	xbo
㠴	dsq
鹢	wwlt
夓	zytx
揨	bqht
㮪	mygm
芅	vn
㚎	md
葹	vqzv
䩟	vlmg
漗	ehxe
鲓	lytg
犪	bwkx
䂂	kkku
耥	bwph
㞀	nbr
㞎	jj
㞓	jfk
倿	oyx
瞲	kcsh
㠢	dlcc
韀	vlqr
槞	mykd
潐	eour
醼	jtvr
墘	ybkg
䰭	tdtc
愒	ikfd
佀	oh
阾	swa
䵨	lyrq
苵	vim
郂	qcws
薥	vlfl
簺	zavy
㑺	ooug
㲥	qbhu
䂏	zmsh
踧	jipx
㐪	qdw
蚏	lf
盰	ky
轪	bm
簄	zqjj
斖	qzyk
焧	rwce
㗵	hrrw
糄	rqjd
㥍	ivw
馂	zcwx
牜	bbbb
篅	zdtd
㤞	iain
鼧	fraf
尜	pmp
捦	bn
梱	mhm
㱝	tzif
䆧	awpx
㿤	kmk
僃	ovff
㱓	owa
宊	am
浀	ehv
俆	owm
㢎	qibf
㐯	qhhk
僊	ojmj
耚	bwix
埦	yazg
盽	kb
倶	oktw
㶩	rao
巺	jjtw
浳	enf
㨎	btdm
毮	bpiu
桙	mcb
觍	dvwo
桰	mfnh
㙤	yinb
泈	exw
摦	bmyc
邧	yos
浺	eihi
蚫	lfj
稑	pywy
㢼	gr
锳	nvdm
徧	pqjd
虰	lt
帬	sihd
㡨	dwwn
跘	jwb
䔹	vswp
堣	ykdq
芓	vn
䯆	gfd
艞	fzor
毼	kfwu
䙛	aehc
苙	vy
珃	udy
踠	jazg
滀	eqcl
㿽	wgl
鄨	rxhj
㿶	eaqx
喯	hmbv
鼔	yhwx
䒌	akej
㣯	pjpf
㑀	omq
䑷	fqjf
溋	egxl
孨	nnn
芌	vyg
媺	xdtx
㗑	hutb
柖	msh
䩖	vlpi
愽	ibqb
嵈	dryx
邒	ts
䊈	rzjw
㿳	ixcl
谉	gaki
㘟	hv
㢙	qvhf
噣	hlfl
嵮	dbkw
塽	ymxx
䰜	gthg
㘴	hwy
斪	fhz
酦	jtdq
浉	eotd
杒	msq
墥	yyky
趻	jwa
㷷	rjjw
罙	awmm
䅆	pwzw
汷	ex
䝢	pklx
仩	oi
嶥	dtww
髠	upg
藃	vqhw
䌺	ck
趓	yogm
暯	kvkm
䶃	frwa
湧	ecff
斳	vhuz
蛷	lbrq
㺮	uyg
巤	chxr
䀕	kgi
舤	fgq
侅	oqcw
俷	ofj
㸠	zor
犼	pnd
浱	etyc
毥	ufk
䓍	vky
椛	mvof
㥭	imir
㼛	tvtq
爢	qmmr
獉	pmp
偢	opr
蔈	vjyp
蛃	ltdw
㷨	rdxb
脜	ftk
嗭	bkhf
泆	eim
䩶	vldl
熝	rqvf
兡	jotk
稢	pnht
郀	mygs
㶿	rban
䭪	zkty
瓩	tigb
豴	pedj
䃨	jghl
祱	awj
冹	wbxq
擏	bvfx
䶁	yhwk
㛌	xcb
㩧	bkvr
䑥	fgq
漈	ezyp
枎	mm
㖒	hwgi
䒞	vao
䵺	ykzz
㢥	dthn
㞽	dni
㵕	eccp
趭	yoor
㚞	mmm
恑	iztg
斀	lflx
壭	ys
逈	idha
櫤	mzwo
䀘	ktv
跊	jbw
圢	yt
㷄	rkm
筎	zxh
娵	xkx
骎	gsax
筻	ztkx
逤	epia
痭	qff
觾	zfvr
㻠	uawm
莭	vscs
伹	ok
猈	plb
峚	dmy
䔘	vzbk
呰	ofh
㡱	qzq
浐	eyi
蕕	vpwt
䙲	jm
虩	pkpg
樷	mmkx
尀	shb
䟸	jzv
茙	vnb
媉	xjty
杙	mn
澻	ewpa
暃	kouu
辢	mhyb
䟭	jziy
黈	vlwu
欬	qcww
趐	yoss
烡	rvw
䓩	vmbx
㑪	oqoy
㱱	tzlc
巎	dtkx
湠	edbr
藔	vamp
㤺	iqp
厧	tbkw
瞉	yatx
幐	fwmd
䘕	pqgy
汈	est
䣈	hjhj
倛	ovw
裻	ipxc
溙	emir
拪	bj
畉	lm
䂞	jm
娧	xwj
㛘	xban
痚	qyn
圀	hwq
痳	qmm
楑	mztm
鲿	lpac
栘	mzz
㨜	binq
郮	fyhs
䩱	vlwo
呝	hqjg
慆	irf
乯	iwbg
蹐	jrwf
㞳	dwb
濭	evyl
㯻	thim
扙	btx
䂫	jxb
蕱	vppf
䩙	vlqc
㝂	nbz
䥾	natt
朂	kkf
瓟	cfj
㚛	mfk
鬙	upwk
㧔	bni
䘣	aof
婻	xbdy
簗	zesm
琎	uva
黬	lyrh
瓻	xbdq
谸	ibrh
厺	mc
鬋	upwo
䆆	phhm
竏	yib
傰	odff
榰	myfk
乽	ykg
挓	bain
㼷	dtdq
棎	mawm
潳	ejyk
蘽	vllm
濓	eyip
㟣	dmwc
杴	mzw
㟂	djw
㚉	gzz
阯	so
䟉	yoll
眴	kfk
宔	aqu
恊	ifff
㡌	ddyf
䞽	yobp
膖	fxba
叆	ycrx
庱	qywx
㳰	eqcv
㽵	qy
髒	gfvv
罧	lmm
竡	ytk
㻆	ucf
雫	rtq
桞	mzs
䐅	fjzm
㙈	ying
㵞	epre
㘍	hpon
椸	mqzv
䣄	wms
瑿	szmq
㥼	itor
哶	hoty
㟒	dsih
㟵	dlto
眽	kzc
㴽	eire
陼	syk
柨	mbd
䟶	jwwy
䅸	pvyb
㓂	ayox
弌	nt
挶	bjsh
㾊	qmd
呺	hhtg
塀	yjwv
挵	buv
坆	yx
埼	ymth
鋚	oixn
䔧	vpom
㝌	azq
䰑	uprd
橠	mqzc
搷	bbkw
阠	sgb
膗	fdou
䟀	yowy
㓿	pwio
楲	mnix
飖	rzbx
㓋	wvw
䐍	fyhw
弿	avwg
罦	lrn
屃	jd
塏	ydtw
汢	ey
燸	rrtd
穵	awg
䉁	zkwa
弜	gg
伆	ofo
榙	mvwh
妚	xti
罽	ltro
苭	vcf
簱	zqvw
巹	srtd
榾	mgf
㺐	pckm
慭	trme
㥠	isof
韽	wajk
尯	nztg
䵊	fqvw
蘶	vpxc
峌	dtcy
雿	ror
暽	krzb
遾	zywa
屸	dy
曧	kthl
㧺	birk
偰	obsm
扠	bxq
跱	jyb
櫫	pykm
䆕	awsw
龂	owdz
䦸	dkdq
㯊	mtor
㳸	evof
蕧	vpzx
菷	vsad
潅	ezbu
㢪	gyg
䙀	aff
呌	hwb
㕜	hix
䣑	tkys
㗏	htio
掽	bwp
韯	boun
搤	bwwl
㥟	ijp
瞖	szmk
㣊	xppp
䏄	kawy
裵	qouc
丂	tggg
鹲	vatt
溸	eucp
複	azkx
搆	bvdy
偮	ohk
嶻	dbon
湵	ewuq
腟	faty
尅	job
䖨	lj
睅	kky
㪙	kmx
㷙	rwfo
噮	hltc
豜	ptv
佺	owu
鞉	vlor
菤	vwmg
䐖	fjr
䨗	rrn
䈭	zlc
玨	uu
梞	msde
䀟	kgo
㓒	wnwp
煓	rdtd
㧘	ofb
䄆	aij
猘	pbdo
揊	bthl
癍	ququ
丵	pwy
萭	vild
娒	xzjw
䠷	idur
㶋	eppu
隒	swsp
廜	qjyk
塖	ypif
噷	hykw
抣	bfw
㤁	tme
辧	ybsb
皉	kof
玡	usii
蒝	vtkp
靐	rlrl
竓	yu
蜌	lify
㶔	ellm
峼	dbh
袽	axh
䖋	ingw
兏	tio
㰊	mywr
䅜	pity
䒢	vfs
㡉	dgqc
㚅	xtiu
蛌	lc
㼟	ktiq
疿	qgo
㡗	dzig
㪧	whsx
儠	ochr
㬄	ktyp
滜	ekmb
裬	aywx
㷅	kxr
唨	hsk
陃	stdw
畷	lxxx
滬	eqjj
婓	ouux
抺	bbw
䖹	loty
䦼	ssw
蟺	lqht
䐼	fbsp
牅	zqbf
趩	yolw
衺	qsic
馠	pkwh
痗	qzjw
䐪	foug
㪼	thz
扤	bto
砮	xxj
唟	ychf
徍	pyy
䂘	jxq
㒵	kw
捚	bky
䈨	zssc
侫	oqx
䨁	csiu
旓	qzpf
㪞	dykx
隚	spay
攓	bavo
㾆	qdy
㼍	bwc
䘵	asir
伵	oho
㪥	inkx
䓷	vepy
忲	imq
偆	omk
砐	jgq
羪	wuqc
笝	zhx
恮	iwu
䚠	zfkf
鞐	vliq
蝚	lcsm
葥	vwfo
骩	gfg
聸	kzth
蚆	lj
劧	bf
葴	vnih
帇	bd
㤩	xhe
䠔	jwp
嗢	hkl
姈	xwa
昋	tmk
黱	fwmr
䓄	vpz
玏	uf
茓	vaw
䠊	jouu
侞	oxh
㫱	kyp
䘿	ajdd
痬	qkfo
礂	jyhh
㪋	kyix
傫	olcp
庍	qz
䢼	vws
饦	zin
澔	ekbh
䍈	zbdw
啝	hph
䠓	jwjt
坓	vy
犵	pzg
䙜	axba
皶	mktx
蓡	vesx
韺	ykvm
䔴	vddx
臖	zydf
袚	abxq
箽	zity
㝕	aex
萗	vayp
㴄	ehwd
恠	ibiy
儏	oizr
葖	vawm
㩙	bavy
琡	uipx
櫄	mitr
柌	msth
穾	awim
凨	gyc
鲬	lcf
暲	kykb
䁨	kqhs
広	qc
敆	whix
畞	blzq
窯	awwr
嘫	hzmr
袬	qchc
靯	vly
蜨	ltso
㢚	qinf
㹏	bvhu
㭡	mhx
䩏	tlvq
臹	tcyf
㺳	uix
葄	vfzy
䚙	zftt
饹	zxh
傔	owsp
㭤	mgt
㤒	imb
醀	jtou
㻳	uvpo
㽊	uhrq
㣙	pl
廵	cg
㬾	szmf
㽙	lco
徆	pj
㬷	fhm
麁	zqvf
㰑	meem
䙎	arcm
䇆	ywb
裋	athw
虷	ly
㹠	pnd
袺	ayh
麞	qvib
䃽	abx
摢	binb
阓	dld
䄯	ptv
梥	awcm
岞	dziy
颣	rcpd
㚗	mk
㐋	yg
乤	tqg
䵞	lyro
垜	ygm
桍	mmyg
䯉	gfzw
䯘	gfao
涊	esqe
怟	ifnq
莑	vxb
㒭	jj
㷎	rkfd
蒽	vhme
䪁	vlpm
䃪	jqht
䕴	vpor
晹	kkfo
凓	wjm
煷	rqhg
鸤	jgt
䅩	pbxw
晊	ktcy
䕄	vsrl
㞚	jibf
菎	vkif
㕣	wh
䇘	ztjt
殐	tzmh
㐕	lg
㜘	xink
甂	qjdq
卋	bvvv
貈	pf
㱾	qcwx
䴨	qvip
䵇	qmmx
唒	hjt
罊	bkdd
嘙	heix
聀	kn
杕	mm
䘊	lzlq
尓	zp
槏	mwsp
俼	oqcf
䎄	shss
蜑	iogl
磦	jjyp
郍	fs
靀	rvap
隨	sbya
蚈	ltv
㐒	shg
㻍	uhtm
㕑	tyhb
幈	djwv
䣵	jtk
潗	eoum
蝑	lsof
篹	zkmg
劋	hhho
帢	dwh
㓝	vo
䕏	vwun
㳁	etw
牓	zeaq
昺	ktdw
羑	wuzq
槱	mjtr
㭓	mcv
瘆	qcmp
䍖	lfj
䃀	jtbx
㭻	mpdh
䘸	aqoq
昍	kk
皛	kkk
悹	ahe
㞌	jn
㵣	ekfw
垹	ybs
籧	zina
㢌	qsth
䑻	fqzn
偋	ojwv
偔	ohhg
蚚	lz
孁	rhhx
祵	ahm
㧪	bztg
䓺	vwum
䢮	rla
嫍	xrf
畮	lzjw
䈈	zfj
盷	kfw
塪	yrf
䉭	zchr
泝	ezq
䨌	ryo
敘	wmx
䀳	kmh
䢘	aba
肷	fzw
䢥	toka
灷	rv
涜	eyao
棭	mqoq
薒	vizr
涄	eltg
䀜	fok
鲀	lnd
査	mk
瑱	ubkw
挜	btp
嫛	szmx
翏	sswp
匜	sv
嵞	wmdd
蟞	rxl
艃	fky
熆	rycl
徔	pva
䢜	sada
愙	axhe
呅	hq
㘁	hlyy
坺	ybxq
砛	jwa
焞	rqhn
蛢	lwv
䪈	vlla
䍰	wuhm
醠	jtdl
䃳	jchr
橴	mofp
塨	yvwp
䛗	suh
卹	ils
㛜	oixx
疢	qr
㞦	dg
濐	ekyk
椷	mnih
䍹	wukm
㡺	qkt
㕈	tqc
抋	be
梋	mhf
㵚	ewxn
䘘	pucy
䉤	zrxx
㝺	wspi
㴼	eaok
肰	fm
㕚	xqqq
㰵	qwww
䭳	pxlk
窌	awfs
䈞	zqhk
㥄	iywx
櫲	mcsp
㤷	iwah
靤	tlfj
爫	rrrr
㛃	bsx
䑽	fkss
侐	oil
㙫	youm
㛮	xarx
佖	oei
㭊	mz
椥	mzmh
㨪	bkpo
婱	gqcx
珦	uidh
䁇	aeik
䃎	jmzz
㽫	qcol
欨	fhzw
㵿	ekkk
㦸	ikbn
芶	vfc
䢷	fqs
哱	hban
荵	vsqe
㭯	mkd
玘	usd
凚	wmmp
檍	myke
㶢	rg
㞸	dti
㒒	opww
䂉	csim
䑐	szp
䃜	szmj
㑞	orv
郕	nfs
㯖	mble
䖥	csil
丟	uc
䯟	gfwp
㬁	kewh
枅	mtv
戨	thtn
㒛	ossu
蕼	vub
㻗	ouuq
搮	bjm
㖉	hwo
谿	rcmh
敠	xxxx
䓲	vowj
蕏	vpyk
栯	mbf
媎	xyk
硍	jsc
䗇	lfr
抰	bdm
愃	iatt
㩰	bvhm
㛱	xltc
桇	xhm
虂	vrjh
夅	xbbb
㔺	bnb
䂴	juh
嵁	dvwd
嘃	hqbf
炃	wsr
抙	bb
䚟	zfkb
螔	lzig
䋰	kwcp
䑠	fs
醓	jtal
郶	yhhj
譱	wuuh
錱	nuu
䨛	rmz
霯	rztw
憿	ikqx
潨	eilp
鼶	frzg
蟕	loff
汖	dir
㮕	mtdm
減	enih
埮	yrr
樁	mmf
㷾	rinp
埑	bzy
䂣	jof
洊	ebin
豿	pfh
偙	oead
樝	mink
塙	yqhh
帵	dazg
㨗	biso
䋤	ucpq
㖗	hdwa
㯄	mmzj
暥	kkax
悤	hxe
䝙	psx
蓚	voip
縠	yatx
鳑	leaq
㲪	zthu
澞	einm
婅	xfr
乲	wzwg
襕	adml
橭	mjyb
樏	mlcp
䔏	vbha
㤐	ihe
狜	pj
潻	epwr
䇴	zj
愋	iryx
嗘	hrcm
墮	sbyy
趃	yoim
娍	xnf
鋫	pon
睘	lthc
㖰	hfdh
氷	iqr
㼲	tdmq
䠂	mmho
夗	zggg
稘	pvw
藈	vkzm
掋	bqfq
㲡	mypu
藛	vafr
䧛	seaq
䍾	tvss
埵	yity
艗	fwwl
眑	kcf
晧	kbh
漥	eawy
䨽	ouud
䪤	ouul
埄	yxb
䵕	pwij
㟩	sind
㫻	kwd
坬	yc
汋	efq
櫁	mael
㸦	siq
䍛	lhj
萾	vgxl
屝	jouu
稫	pthl
硄	jpto
咉	hdm
㬝	kwlk
䗕	azgl
䀊	essl
篰	zyhs
磏	jwsp
赻	yopi
螝	llc
曢	kamp
㮣	scsm
夎	wwyx
铔	ntp
佉	oyc
螏	lqzm
聤	kqht
䏍	cfff
䖞	lb
焍	rwgi
㮚	ihwm
蝃	lxxx
眣	kim
㣽	xe
憱	iqhq
䆣	awtc
帾	dyk
淾	nir
碋	jdth
悕	ixbd
忦	iwo
㬩	kbbe
窓	awce
狑	pwa
䬤	jwqc
吜	hsy
灺	rv
筃	zhm
䐘	fryx
幙	dvkm
㛸	xyhw
硩	bzj
䔅	vthh
䇩	zkf
䠦	jzmk
睮	kwfo
伂	otd
㖥	hhp
馎	zbqb
蜝	vwl
㙸	yopm
枡	miv
螆	lwcc
榗	mtpk
㮃	mpx
瞐	kkk
䖰	lzc
䢓	atba
搑	bvk
媀	xkdq
䎺	kbdo
麌	qvim
䒕	vp
崉	dirk
豭	pjyx
甮	fof
㲃	ikix
殧	tzqq
㯟	mmsr
抐	bdw
䗠	qzsl
確	jaou
䤋	wjtt
䜷	thwx
㳌	eki
褎	qftc
矵	jo
嬜	ykzx
敩	eanx
営	eahh
䆀	plyr
洏	etd
㑱	ocsm
碂	jayp
悜	ihu
珁	utiq
啳	hwmg
㹾	pxih
嬿	xvhr
匁	fx
耹	kwa
㥵	ihp
㡜	dzyp
䇹	zsih
㥙	ihie
忟	iq
㬰	kw
㔂	rzbo
潌	eawy
䤇	jtax
棿	mfo
㰤	thzw
䇦	zdm
䅍	piyg
㟬	dfix
寑	aosx
鞢	vlvm
茾	vtv
崺	dqzv
㾫	qqjd
赼	yozw
镸	uuuu
柡	myir
厞	touu
捿	btbx
籝	zqhq
㲍	bxu
傹	oyko
㟗	dwss
宷	air
醥	jtjp
㭖	mon
㣴	pvlw
炢	rmq
妭	xbxq
㓼	mwio
赮	ypjx
㙎	ynix
㐀	ottt
氠	uki
䍔	lbc
瓾	pxtq
㲳	fnqm
嶰	dzfb
筦	zayo
涭	erax
㺅	pztm
㧷	btmh
圅	chwy
㝃	nzho
庼	qitd
㚱	xzt
牷	bwu
邌	pfia
彏	gkkx
妑	xj
䄕	airl
舑	ijdy
㰮	tycw
㣒	wlkp
榥	mkpo
霛	rggg
珜	uwu
䒆	fqcx
瞮	kqcx
洰	ess
堹	yity
䨢	rvwd
炘	rz
効	exf
霢	rfzc
㩒	bmmp
剓	pfis
蕫	vyky
迧	kia
枂	mf
䢊	na
栃	mzts
㭽	mqfq
㿅	qpoo
䒵	vxn
㠦	ddbw
鱾	lsd
㙚	ywub
渱	ely
珕	ufff
沶	eyp
鳣	lqht
媱	xrzd
䤐	jtsk
㩢	bvlq
嫷	xsbf
褉	absm
棇	mwce
䄪	pfq
択	bjq
礳	jqmj
杽	mb
䍫	wuaf
硛	jqp
瞏	lyhc
䚦	zfzg
楃	mjty
㬒	kvmv
蓌	vwwx
曂	kvlw
瞂	zbkq
揅	jtvb
㷯	rymb
膐	qzcw
㴙	eibf
刣	cho
䋈	xxcp
嫮	xryg
㾏	qyy
絛	oixp
橧	mwlk
逜	uha
硞	jbh
㓮	fyho
㠯	hhhh
脃	fzj
㴡	epk
㟉	dab
邞	ms
柾	mto
酟	jtih
厖	tnpq
麹	uxfr
勌	wmgf
榤	mzbm
腲	fltc
釀	jtqc
欶	mhzw
㹫	pmg
阇	dyk
觤	zfzg
䉕	zwlk
䯭	upx
鄎	kes
椢	mhuq
憇	ijve
聝	knht
夲	mb
螼	lvhu
䇛	zo
㶸	rfff
笹	zvd
㜫	xpdx
䨥	roux
㩍	bzmd
㴳	eynq
㗆	hvl
跮	jtcy
㰫	bozw
㾮	qku
玆	qcqc
㰇	mbon
䖓	ddig
儫	oqhp
澱	ejvx
㟾	dqbf
㲼	ex
畂	lzq
㶂	eevw
鬳	intt
㛟	xzdm
䆎	pwwn
欀	mqhc
脕	fzho
桵	mrx
膬	fuuu
奷	xib
罋	qcod
刱	vsw
䙫	aiyw
䢃	jhyx
尪	nu
䎟	xtd
妟	kx
㸸	bzth
慗	mhxe
䠨	jzth
鞝	vlph
㬫	vhik
戜	nhu
鬔	upxa
痡	qbq
樀	medj
肣	fwa
磶	jffr
爑	rvor
悁	ihf
笧	zfft
㬏	ktht
嘼	hhlh
銴	bzn
烮	tzor
峝	ddth
遹	csia
㪀	tbx
㣃	gqcg
䨰	revl
睷	kbg
娕	xmh
潝	ewhs
㴪	ekm
㿀	quou
䰰	rtdc
䉇	zvwo
㤡	itzo
湪	ejp
曐	kkku
䈕	zkto
柉	mia
㢓	qykb
珿	uho
粌	rgi
䇚	zoi
岴	dzt
瑖	uzux
窛	awyx
猟	pegb
敋	xhx
㞁	nkf
泴	irl
觟	zfyy
薢	vzfb
䐛	fmk
㑘	onv
㜪	ymzx
㫔	ki
裖	atyc
獈	pwwl
㱗	okm
惎	vwe
斒	qqjd
䍳	wuxx
儵	oixr
㞏	jia
覀	jjjj
㼳	pikq
䰩	yklc
㤰	ozie
瑨	utpk
嶛	dmkp
㝽	nir
㑦	oqjm
㖆	hhv
嫆	xarh
挗	bmg
䈣	ztox
㛑	izxx
銞	fkn
㵈	eexj
堢	yohm
檁	mqhp
蘗	vjhm
拝	btb
慉	iqcl
椘	mma
冣	akx
㧴	bibn
瑸	uazw
焒	rhh
鬶	mdot
櫉	mtyb
䈀	zffo
媣	xegm
蒃	vjp
崾	djx
袀	afw
㵺	ezlb
萔	vbsh
髴	upgo
㚢	ox
倱	okif
旜	qzqt
蝯	lryx
梌	mwm
橿	mtlt
桒	bvm
梬	mltg
艓	fvdm
碫	jzux
䕙	vbon
芖	vm
㚴	xbd
埲	ymb
旴	ktb
碮	jkto
瓺	utiq
匸	ssss
㞝	niij
愝	iskx
叀	tlc
岊	jd
踓	jou
䶏	wgio
姶	xwh
檺	mqhp
䓀	vyh
窉	awtw
鲉	ll
爉	rchr
柶	mho
剢	pqo
骲	gffj
餋	wmwc
㐝	bfhg
䰀	uppx
䏮	ffr
惀	iwd
跲	jwh
渻	epik
㝫	asxu
哰	hab
泂	edh
䁟	kwuy
漛	ewmr
䃲	jfgl
鞵	vlrm
槙	mbkw
拋	bnf
煪	rwjt
灖	eqmu
揈	bfuh
淊	ezf
葽	vjx
焈	qjjr
芉	vy
踆	jcwx
荌	vax
䏜	fgq
蕚	vhhg
佡	owd
揤	bscs
焣	kxr
㱈	mmyw
酓	wajt
燅	ywyr
黋	ptow
㠸	dm
匌	fwh
捁	bbh
㡐	dwfo
槨	mqhs
罫	lyyi
㮦	mbap
郆	yhs
䒮	vagq
㺪	ui
缼	zbdw
㑊	oqp
㐫	qxd
㱡	tzbo
叒	xxx
䒼	vhv
剘	vwo
䏥	fdy
琷	uwud
筭	zuv
橲	myhh
㴎	emyp
㕗	wuzc
㜼	xllk
㨟	bdtw
鞬	vlbg
䕬	vgtt
㿯	whix
祮	ayh
㕩	hb
匓	fscx
嶉	dhou
瓰	tigs
檨	mwuw
㶙	eepu
橜	twdm
埪	yawy
䗸	qcol
牐	zibf
胓	fyw
旫	ks
皀	kf
䧁	sfh
醷	jtye
毎	zjb
抸	bia
鲗	ldo
㕎	tycl
䐉	fcl
㜎	xrcm
礙	jfzo
秂	pw
㢦	thtn
庈	qwa
躿	idur
罇	zbdb
彽	pfnq
㦵	bwn
㜋	xwwl
㒗	ovay
歯	ord
秎	pws
珛	ubf
塎	yarh
旿	kzb
䓉	vsis
鬐	upyk
㐹	ou
黁	qmmk
芐	vtq
㵬	efgl
秵	phm
巶	shj
斉	qoy
獛	ppwm
㸿	byag
捹	bmbv
䈯	zbkw
苆	vns
屧	jpvm
䅗	ppx
懁	iltc
䑤	fwa
㫁	cctz
毃	qhdx
菶	vmb
䕇	vqlc
麔	qvih
䃓	jvdy
傎	obkw
䍼	wusk
辳	mmtc
䔫	vsod
㴅	irhh
悽	itbx
弅	wsv
㾋	qom
㛫	xkfo
牞	bf
秜	pjf
㷞	rtkn
竆	awih
萣	vato
㶻	xbr
秙	pj
㨈	bqoy
㦈	iwul
阫	sti
怘	je
旽	knd
菨	vyx
慾	rhze
䍂	zbdb
禢	akss
䖉	intb
嵄	dwum
䟧	jl
㹿	pikb
㨊	bbyf
葜	vbsm
倳	othb
蟨	twdl
蹏	jzig
喓	hjx
䟞	jpi
䐁	fpq
祒	ash
䞧	yozh
噖	huua
禤	alss
崜	dity
䆽	awip
冿	wb
䧽	irou
団	hb
阤	sv
䗆	lah
㱏	yo
齢	orda
螌	fgxl
䜯	rhfr
㯎	muhm
衦	ay
艐	fxdx
肍	fg
䍉	zbdw
傉	otyb
㱚	tzf
傗	oqcl
㣪	pryx
嗸	ufxh
惤	igqc
酘	jtgx
矺	jin
㨑	bxdx
㘀	hfr
侙	ony
鼣	frm
碠	jqht
黦	lyrg
䞯	yorn
䓜	vefq
㧗	bof
畨	rlll
䚣	zfko
擶	bzwo
菗	vbl
敁	ihix
佷	osc
㝘	auh
懆	ihhm
黺	prws
㞲	dhi
僢	orab
裶	aouu
禫	ajkb
㰹	nitw
啹	hjj
㯴	mvah
䄸	pk
㰲	nhtw
穊	psco
㽅	zthq
趥	yowt
捔	bzf
晪	kdvw
䀦	kj
劤	zf
襖	aidm
煏	rthl
剳	vwho
鐾	jhyn
徲	pjib
䂕	zmjp
痌	qdth
袥	aj
葊	vwhv
䨐	rwh
碐	jywx
䎇	fss
蜏	lpg
辥	dihb
勄	zjwf
壱	yaf
䏷	fky
媅	xvwd
㫢	kyc
穛	pour
茒	vzs
㢅	quv
㿝	kc
秺	pain
尌	yhwb
冮	wy
湸	eqhg
䇡	zat
葏	veb
嚺	hlwa
藳	vqhp
㽘	lqg
掞	brr
莙	vsih
鼵	fram
隀	sity
泿	esc
雊	fhou
茠	vom
㫭	kyb
胘	fqc
蚑	lbx
㧡	bqcw
骿	gfwv
㫆	qwp
㕲	hm
舽	fxb
㞯	sdd
㤾	iawm
䟨	jsin
䜽	thwo
琭	usir
䗣	vll
竌	yg
䧩	sskx
糤	rvfx
疀	clto
㻭	uqcb
㼡	bwtq
猶	pwjt
䯧	qhah
镼	ujdd
腞	fjp
抯	bk
㝡	akx
蒚	vtht
枻	mvd
䅯	pqbh
萂	vph
箷	zqzv
侴	wsyo
皒	kibn
㹇	bkfd
剝	jtro
䘟	agi
㡂	tzod
䅦	pvl
圥	yo
湱	ebj
椪	mwp
朳	mw
痩	qkix
䣺	jthf
皭	krlb
蒣	vpwm
㧆	bd
䝋	payp
笟	zc
舎	wyh
褿	avkk
㫟	kgh
䙣	atmu
偳	odtd
㽹	qzx
㘿	yky
畩	lqc
楍	mhhh
䂢	jxw
赥	ypzw
栦	mep
壿	ywjb
宲	ahm
㣝	pnb
㹜	mm
㗋	hztm
榐	mjvc
㓢	xho
脎	fxm
椇	mkw
扜	btb
峇	dwh
滒	ethh
䘑	ilqr
毜	up
寭	atke
璒	uztw
㣎	kpp
簛	zvwz
䂯	jqy
懻	iiyw
㛤	xtdq
栔	bsm
㽡	llb
䊮	rssu
杸	mgx
㮽	mfgx
䁄	kywy
㟆	dofb
瀪	zjwr
螨	lvtw
晆	kyy
㹮	ptk
祍	aiy
涴	eazg
汄	ew
㓰	tldo
㯪	mrwa
䣟	soss
㪫	iatx
釡	wn
痻	qfnk
啇	edj
蔜	vufx
韰	izxt
榬	myhc
㓆	wwf
払	bc
螚	cffl
臰	ktzf
䔊	vuwv
聑	kk
倃	oxih
堧	ytdm
峕	dqk
夻	mh
雽	riwb
呏	hiv
栆	mhw
棲	mtbx
濣	ebkb
㳬	ezso
㵷	ybeb
罯	lyk
䣶	jtij
瑹	uvwm
蠥	dihl
䣀	ztgs
㵉	eemm
蠗	lssu
㟖	duv
溞	exql
仦	op
熶	rkkx
摬	byko
蒀	vkl
䣨	jtin
䆚	awdh
雧	ouom
㓏	wdwh
脪	fxbd
䅼	pklx
棻	vwsm
㘦	yf
翭	ssom
鬇	upzi
䉓	zmkm
圏	hwmd
嫤	xvhu
蹆	jsca
褃	aof
稰	psof
倁	ozmh
㳴	eeiy
汬	vir
㚏	mv
䊅	rzh
璬	ukqx
榺	fwmm
枩	mwc
苲	vziy
妦	xb
弻	gthg
䣤	kkos
郠	tkxs
哖	hzb
䤰	yzwn
疉	lllt
汥	ebx
䵵	zkmr
䂌	csiy
翷	rzbs
趚	yomh
牥	bq
聣	kfo
䊑	rpdh
凾	shxd
膉	fwwl
欚	mjpl
䟖	jd
㽲	qtg
赲	yof
桾	msih
陱	sfr
毑	jwv
䊚	riha
籷	rin
㓵	hhyo
翓	yhss
朩	mmmm
㗧	hawy
楀	mild
㸭	bj
婎	xou
暒	kkiu
辸	ga
㝏	awo
䊨	qhfg
䩚	vlfq
丆	tttt
昖	kwc
簾	zqwp
爯	rdy
偪	othl
榞	mtkp
㕽	hiqw
䣒	lds
㘭	ycs
膵	fvqb
䧗	szkx
寀	arm
溕	eatp
崐	dkif
朢	sfu
娀	xnb
䣍	mls
㕃	ttv
淃	ewmg
㧿	bwwo
醤	irbt
粂	zqr
玹	uqc
嗛	hwsp
耺	kyc
㿺	kvwx
罝	lk
㳚	eniq
㛈	xytg
厵	tkpp
峬	dbq
躣	jkku
扨	bsq
䄎	amth
㢸	ggx
兓	soso
浖	erb
梫	msax
卾	hhys
䗭	lhhe
迿	fka
仴	of
稟	qhhp
螑	lkm
烓	ryy
㼗	ttiq
䌾	cbdy
㘬	yfc
栻	mny
毸	ule
䓥	wvkb
嗀	yatx
萿	veij
㗕	hvdy
瓵	chtq
眔	lir
泙	eyw
浶	eab
鄤	klxs
埜	mmy
遅	jwua
䝞	ping
嵳	dwuy
醁	jtsr
疓	qg
䆺	awil
湣	esik
㠃	dedj
㿷	wuyx
嵪	dqhh
粬	rhv
燨	rwun
妴	zgx
毪	ucb
䠡	jink
䜰	rhkb
㠕	dslc
炏	rr
䪄	vlvw
尡	ptof
澛	elk
䟽	jqcp
歴	tmmo
䗦	lxba
䑩	fj
䅊	pqin
㜠	xdou
塠	yiha
㻤	uvfh
暙	kmk
櫗	mvlq
湆	eyk
偼	oiso
蜫	lkif
遟	jyba
褕	awfo
宆	ag
髤	upm
寚	auzd
樬	mhxe
汳	ezx
㷤	yatx
䩺	vlws
䩣	vlwm
䒐	vlaj
㺼	uso
棤	mvk
豥	pqcw
浟	eoix
佨	ofj
䆡	awqc
窐	awyy
䧌	srx
腛	fjty
媶	xvk
䔽	vekd
玴	uvd
溹	ebap
㸜	zawy
仭	osq
箮	zatt
瑌	utdm
藄	vvwp
㘸	tzfy
䨂	prou
珬	unit
叺	hw
擵	bqmb
搩	bzbm
婜	sxx
簬	zjxh
觲	zfwb
櫀	mvwp
碄	jmm
糡	ryko
燄	zfrr
㗞	hjix
㯁	msyh
浭	etkx
陫	souu
幭	dvlq
痸	qbdo
䗛	loif
蘌	vpzp
畖	lc
牂	zwu
䊓	rkto
䩓	vlfc
矰	zmwk
埈	ycwx
㳣	eyf
㻒	uhp
苸	viwb
㯓	mwhs
湼	efy
䆯	awxx
㳑	el
㱬	tzlc
埣	yqwb
䄜	aqxc
灈	ekku
㯘	myyw
䩬	vlmb
屇	jl
澿	emmp
眝	kat
彸	pwc
槾	mklx
烥	rs
濨	ewce
㾘	qtkx
㷳	toor
茝	vsii
桛	mitq
橀	mqcl
䧥	stke
勠	sswf
浨	eam
灲	ro
鹓	azgt
烆	rpy
辪	oihb
毶	ucmp
盫	whjl
淯	eqcf
藗	vmha
㨭	bqjj
勎	ywyf
䶈	frbb
孒	st
㦟	pkye
暤	kkmb
㭁	mg
癔	qyke
䃈	jifk
韹	ykku
㕅	tki
㚾	xj
泋	ebv
萲	vryx
䁤	kedj
猅	pouu
䩾	vlqr
蜹	lvdw
㻃	hvuq
脻	ftso
㠬	yhm
溄	edxb
劶	zthf
孞	ne
䓡	vzmh
羗	wudc
涘	eczm
䁁	kqhp
肳	ffo
獏	pvkm
羱	wutp
㙕	ylf
䓅	vez
猽	pake
痁	qih
凖	woub
㥉	iyh
䯜	gfko
剏	wvsq
䲤	lejt
㸴	jb
楜	mjf
䵋	vlwf
獝	pcsh
㦑	iskx
䢦	qcra
呬	hho
㙮	yzwh
垘	yom
訄	guh
唍	hayo
敔	uhx
㪄	gox
䀼	ktyc
菑	vcl
狟	ptkt
昚	mkkk
䄟	uuup
㶮	tdwr
坥	yk
茤	vzz
揺	bryd
䵙	pwiz
㑭	olto
䌠	nitp
㡠	dztw
彴	pfq
躽	idux
䕰	vril
祩	abw
躸	iduh
㝶	lob
㢈	qou
侌	wayc
慂	ecfe
趈	yoih
瓱	tigu
鲺	lgil
䵫	azgr
槒	mqcl
佄	ov
浽	erx
揫	prb
㤄	itd
唖	htht
䈌	zek
㧳	bwsb
羍	mwu
㜔	xyj
晬	kqwb
䢡	vdma
鼌	kthl
㾔	qhh
䑯	fwgi
㗠	xchf
伿	ohw
㼮	tbxq
䒔	vw
䯍	gfwa
㜂	yybx
喥	hqvx
䘃	llyy
嵚	dnzw
窡	awxx
㞈	nqjd
䢔	wha
珸	uuh
凬	gtk
昣	kwp
䦊	uip
㤤	ikx
㭏	mbs
犌	bjyx
嫏	xqss
舕	ijrr
雃	tvou
㐨	csii
㖼	hvm
簨	zjjw
䕀	vyyw
瑀	uild
茲	vcc
㲤	qhtu
侽	olf
潓	etke
䦁	nbs
䘱	qrhc
唚	hsax
䑝	hhab
䗑	lky
䇟	zzf
篈	zyyb
糀	rvof
㑑	ok
坾	yat
幮	dqyb
琲	uouu
娬	xton
筳	ziyg
㭝	mmg
衈	ilk
膸	fbya
㺌	pwsp
厇	tin
䘔	ilah
㾪	qpik
豗	top
姯	xpto
濍	evfe
聏	ktd
䃭	jnie
腏	fxxx
呄	gj
箠	zity
睸	kjk
揑	bfy
䛓	ozuh
岟	ddm
羖	wugx
刌	bo
疞	qyg
摉	barz
颕	fypd
㝦	aoug
厐	tbfq
㙒	lcsy
㙀	yawg
麏	qvih
㻖	ubr
䉟	zbox
橣	maef
炈	rgx
㪰	qr
㭆	gbw
鄀	vbhs
歊	qhdw
姡	xij
媨	xwjt
椗	mato
脤	ftyc
㙽	ymtk
甆	wccq
䕒	vyhh
㞩	dgq
聄	kwp
玔	up
逷	kfoa
偦	osof
䭮	upwk
姖	xss
㳧	ekd
肙	hfff
㑟	oztw
澵	eymz
湜	ekto
啔	qjnh
岻	dfnq
扻	bzw
楶	wzwm
㒺	dwwd
椱	mzkx
虡	inpw
㵳	easp
覉	jvlh
㦼	mfn
䢳	gs
扲	bwa
㳕	ewy
㳞	eohi
磰	jwuh
踜	jywx
犕	bvif
䈉	zyx
滰	eyko
㮤	arhm
㙜	qhdy
杛	mg
靰	vlto
䃊	jvk
娞	xrx
屽	dy
䓒	vfl
䎂	ssfj
㗩	hssk
樖	whmh
㔬	fkb
磘	jrzd
䁺	klyy
楯	mzbk
珡	uuw
笇	zqi
䁓	kxdx
迖	ma
靽	vlwb
竗	ypi
壖	yrtd
憟	ijr
擈	bpww
悋	iqh
姽	xztg
珇	uk
荱	vju
㡄	dfk
畻	lwmy
䍧	bwu
糉	rxdx
䠘	jhxf
葢	vmql
䈗	zocx
羛	wugo
皨	kkky
㽎	vwdo
徃	piu
䐯	flcp
蔸	vkfo
㑌	osu
莬	vzho
䩄	tldo
玤	ub
狇	pm
雘	fqvx
恲	iwv
㢻	gpx
鄇	oszs
怽	ibw
袏	aby
臵	tcyh
䒦	via
㐶	oj
莍	vbrq
玝	uzb
槅	mtht
棷	mkx
垑	yzz
鬅	upff
仢	ofq
㖛	jhf
挋	bs
㪆	fnqx
稉	ptkx
奨	irbm
噳	hinm
乮	fsg
怑	iwb
镹	uzq
蔀	vyhs
萉	vfj
邚	xs
搳	babh
蟭	lour
凇	wmwc
唌	hiog
瀮	ermm
菂	vkfq
㖍	wbhf
㡛	dvqp
攗	bqvr
㭰	ofmd
唣	hknv
羦	wuao
晘	kky
齇	kltk
隇	snix
蠴	lvlk
㞻	dhtg
磆	jgf
眹	kwm
垊	ysin
掫	bkx
隥	sztw
乥	iwg
竩	yak
㪢	fixx
痓	qtcy
㧜	bsd
穔	pvlw
昬	sink
㘗	hkku
薻	vecm
笎	zyo
㧮	bf
蛈	lim
䪠	igit
㔣	lllf
㩕	brwa
䔸	vmmm
㵨	jhyr
揝	bxik
䖽	pol
㢲	ggtw
傟	owcs
屚	jr
糋	rwfo
䔜	vkdy
啙	ofhh
爀	rypp
㷉	jyrb
㲜	rru
侚	ofk
邽	yys
䈬	zebq
庬	qnpq
仛	oin
隞	sufx
梡	mayo
恜	iny
㺯	um
裩	akif
澘	emmk
㹋	boip
廅	qycl
䄑	afnk
㒕	oqcu
煃	rmyy
橔	mqhx
䠎	jjty
徦	pjyx
䓳	vpsc
遌	hhya
菭	vech
蛦	lmg
梹	mztw
裿	amth
䪎	vldh
煘	rnih
憓	itke
㫵	kouu
䎽	kfnk
䐶	fsok
衚	pjfy
稛	php
搘	byfk
梚	mzho
㭩	mrb
憘	iyhh
虳	lfq
㦒	iluh
耂	yyyy
袞	ehc
箲	zebo
㨨	bfsl
馉	zgf
葈	vchm
㔚	ijf
昈	kqj
㽝	tzol
頀	ykvx
鍌	ebon
戯	inpn
䠗	jkm
砕	jgb
唈	hhj
盝	sirl
䄂	al
㹀	bban
㪒	foix
䙉	azbk
㾂	qch
燉	rqhx
蟌	lhxe
㪝	mlix
䝒	pkxp
敯	sinx
鞦	vlpr
㑻	oaed
袙	ak
㪾	xhz
雟	douh
曃	kbra
眰	ktcy
杇	myg
㮌	mtl
㙴	yzth
庢	qtcy
蒮	vaou
矂	khhm
㼉	cao
㡲	qn
馛	pkbq
萞	vdwf
䅝	pawy
乕	zyd
昑	kwa
䎶	kki
霨	rjyb
衭	am
勫	irlf
㾧	qkm
嘝	hzfb
䒹	vbw
䎤	bwjh
炓	rwb
嶬	dwun
㲊	iatx
脡	fiyg
廠	qpdx
穟	pwpa
臛	frou
㔆	soso
袾	abw
䟱	jmd
㔵	sjjw
衃	ilti
䙒	aqcl
䢆	agtb
挮	bwgi
㖪	hnht
㰨	hwzw
䆜	awbf
䇽	zbz
㛪	xml
乻	qwwg
狖	paw
嶞	sbyd
㔏	jjjo
峎	dsc
䖐	zing
䴡	tpif
㓩	zfo
䎢	bwzg
蓏	vcc
䘻	aqcf
柀	mix
䒊	wgzj
㵭	eykr
奟	mff
㻷	umdd
巙	dwkx
䍗	lqc
㯭	minf
鄓	kms
㩎	bkfm
戻	qjm
㓷	kmo
㒩	ojpl
傽	oykb
䣱	jtfh
䰇	upyk
莇	vkf
鞡	vlby
彨	tdqp
厫	tufx
瑑	ujp
冐	dyf
䎫	bwxx
㕻	qtih
䘩	afk
麚	qvix
荕	vff
弡	gss
䔂	vayb
挔	bqc
䎐	bkbs
㡏	dwfo
㰕	mwun
㣖	pmq
擖	bvkd
垼	pgxy
瘶	qmhw
洶	efxd
忕	im
璆	ussp
牪	bb
䀯	kbq
蚞	lm
讱	gsq
牻	bnpq
侾	oyn
洭	esu
嘑	hinb
䍐	ly
蓈	vqss
暶	kqzo
洡	ebw
掝	bnht
籰	zkkx
䍞	dxxt
㥪	irx
䨦	reaq
榡	mucp
済	eqoy
潈	elp
豨	pxbd
竂	awmp
氊	uqht
琁	uzso
鄜	qvis
䘴	amwc
刞	ko
桹	mqsc
㒰	wy
琄	uhf
㰠	qgzw
㝔	aex
㴓	ele
潶	elyr
夶	mm
㲑	uir
芲	vwf
遬	mhza
厑	thf
嶎	djyb
籐	zfwr
麼	qmmc
㩀	binx
刵	ko
螦	lucp
炦	rbxq
硣	jyn
䚪	zflc
笵	zeg
䠳	idud
㖾	hhwd
梈	mqhs
籈	zjyq
㴥	edpf
殈	tzil
䨟	reyy
㟍	dqsc
㬞	kdkd
刧	ycs
㬗	kzmr
㴝	powr
狪	pdth
媭	ptdx
蠚	vbhl
搼	bwmb
琠	udvw
蟚	yhwl
圁	huh
昳	kim
㙃	yztw
侰	osih
㚥	xtb
璔	uwlk
㫾	kpdh
䖗	innh
㸆	rbhu
暱	ksvh
䖫	lwy
咟	htk
㺁	pchx
濗	evkd
椞	mzm
妛	dtx
㟈	dbrq
鼨	frxw
䀐	kp
㒎	otmu
姂	xia
䯱	upti
㛶	xdbr
䄶	pgo
䂙	js
渞	ewk
胔	ofdw
彊	gtlt
㚷	xwp
伡	ob
觪	zfyb
甐	rzbq
䜤	gvw
亄	yatd
刬	no
峀	dl
穃	parh
䝇	wop
䍵	wuzi
㣇	jtod
䀣	kei
䐒	fmzz
䠴	iduy
蝰	lmyy
䊳	rqmu
䂸	jnht
愖	ivwd
㴮	ejpf
伱	owp
宩	ar
匢	sfo
䣾	jtak
寗	aeiy
㰯	thww
伔	oag
㥔	iqcf
㶴	rzz
蝹	lkl
慔	ivkm
魊	lcnt
䯺	upfh
峸	dnf
榸	myky
趏	yoij
奃	mfnq
䙵	jyy
愳	kke
㻛	ukfo
褤	ayhc
蘁	vuhh
旇	qzix
䄃	adm
兞	jou
㷺	zfxr
迶	bfa
茖	vxh
敜	waex
䴢	qvim
䙧	aitr
撛	brzb
箥	zeix
㖳	exhf
磝	jufx
惽	isik
偝	oiyf
嫊	xucp
漄	edty
奍	wmo
朶	gm
㮑	mibf
㟲	dtkp
㸘	wxlt
憻	iqht
匫	sfok
䉜	zzmu
蛝	lsc
㥹	rwse
兯	ws
㢖	qirl
嬟	xwun
虗	inzt
郙	bqs
羴	wuwu
䓮	vcsx
㾼	qsca
媟	xvdm
䠺	iduh
㐅	xxxx
㗂	hpik
䃟	jvfx
㛽	xar
藞	vjjj
芁	vg
氻	es
蟃	lklx
豊	hvtw
蕿	vrrx
啯	hhuq
杔	min
㐌	zv
䵠	lyrq
嫭	xinb
㤋	iws
殩	tztr
抅	bfc
箉	zbhf
婳	xtld
䨅	mkpu
莐	veao
㲇	yjgw
漋	esxu
㔾	gggg
蕸	vjya
麘	qvik
芼	vu
䕣	vakd
疻	qhw
烍	rbo
鞖	vlrx
罀	zbdr
吢	eh
㴊	ewdo
颎	frtd
婗	xfo
䑔	ftd
霡	rfqr
鞄	vlfj
渁	eirr
吇	hn
栠	oiym
䁾	kvlq
䇸	zhu
嬘	xwpa
嘊	hdty
耑	dtdd
遖	bdwa
堽	ylto
璙	umkp
涻	ewyh
磢	jmxx
蛫	lztg
彯	jypp
䥒	ghln
㡷	qmt
矹	jto
欯	yhzw
绤	crh
癗	qrl
䜫	rhy
鞺	vlpy
沀	irci
霳	rsxu
椌	mawy
吂	qh
甿	lq
㬋	kosm
姟	xqcw
㸑	zydr
眃	kyc
萺	vdyk
珎	uzp
沍	etjt
霔	requ
胇	fgo
歘	rrrw
柕	mcsi
鼖	bvyx
㔘	ddf
貁	paw
㽪	lwlk
槵	mhhe
䢸	ks
䒙	vi
㤽	ibb
沖	ehi
㮟	mjm
㮖	mvl
烌	rom
殾	ykgx
檤	mwka
洓	emd
甼	lt
晣	kbz
䐤	fwuy
醄	jtfd
熋	cffr
洕	ewf
蝫	lyk
腤	fyk
坰	ydh
疎	somh
帹	dyx
洜	xhir
谻	rhgb
椂	msir
㖡	hqoq
焬	rkfo
㹺	pirk
郳	fos
䇭	zyf
菺	vqjf
塇	yatt
䤙	jtjl
睲	kkiu
悙	iqhs
沨	egx
硉	jb
髉	gfau
榓	meil
峓	dmg
稧	pbsm
㸢	zvif
跕	jih
㡼	qkf
晵	qjxk
㴁	etmv
敥	rrix
蹸	jrzb
跜	jjf
㻊	uzho
亯	qhk
跇	jvd
䢏	wba
礔	jjhb
锧	nzbd
怶	iix
㙶	qhpy
敨	yhx
㡰	qtb
㲂	pdhx
蝏	lqht
躕	jqyb
䤃	jtyk
潫	ewmp
㺀	pfoe
䓕	vyoa
樋	mcfa
洠	ecb
跠	jmg
熥	rcfa
㾽	qiha
殭	tztt
䓱	vofm
肸	fwb
嶴	idrd
㸟	zfk
㙐	ydtd
㺭	un
穽	awv
䇬	zbw
䏃	kake
㷧	rtkp
遀	byfa
侕	otd
墦	yirl
蛶	lrb
䙓	alyc
撲	bpwm
偣	oyk
斻	qzg
墕	ytor
鲼	lbvd
㒊	osqo
巏	dvhu
㶰	rv
咴	hbr
屔	ztjf
堦	yifk
焨	rdyf
妵	xqu
洩	ekf
䔺	vsbf
䄊	aye
㔽	ihh
㰏	mzqh
稙	pbk
㣮	pbdy
㮢	mosm
虘	ink
肂	tzb
筍	zfk
㨍	yybb
儌	okqx
敟	dvwx
㲉	yatx
㻘	uaki
嘠	htkn
鄘	qbfs
䠛	jrzd
撗	bvlw
氝	udw
墇	yykb
蓇	vgf
殶	qugx
㛹	xotx
䚗	zfwc
堄	yfo
弝	gj
窲	awrb
喰	hwqc
漨	exba
崟	dn
鼕	yhww
蟤	ljjw
沕	efo
蝝	ljp
踘	jfr
稪	pzkx
㛋	xwp
䝣	pesm
乊	iwww
㼓	cwsp
咅	yhhh
㔫	bfff
掤	bff
㡫	ckfd
霗	rewa
鼤	frq
瑈	ucsm
柗	mwh
茩	vzth
䦻	sn
瑢	uarh
蚠	wsl
樸	mpwm
渘	ecsm
蟖	lvwz
媻	fgxx
疘	qy
殟	tzkl
䏕	fiy
㣾	ixq
㦿	qjm
吙	hr
䑖	ftso
㐆	zsss
霊	ryp
䑸	fayp
蚃	cl
葼	vxdx
䟬	jzt
埌	yqsc
䁛	klc
鞊	vlyh
鞚	vlay
氶	srrr
桏	mys
恀	izz
啴	hwkb
跒	jth
欫	ztow
殻	yagx
塜	yatp
䇳	zn
䣿	jttl
荹	vop
鞃	vlgc
歁	vwdw
珔	ubin
杚	mzg
嬄	xyaw
筼	zhd
㖢	hqof
㣉	yp
㢁	qzz
幏	dap
䘖	pzby
䣰	jtss
䑦	ffh
乧	wbg
䍜	lou
㔎	dihs
䗏	larx
圡	yq
㨰	becc
䯢	qmmf
䵻	kzzs
䟵	jbrq
嘕	htor
㑧	opn
㲸	eg
睎	kxbd
吅	hh
䃧	sxtj
䅵	pwur
䒝	vxx
栥	wzwm
秿	pbq
蹷	twdo
媘	xifk
㖫	hywx
嗗	hgf
䃄	jqhp
䅅	pyy
䴩	qvip
麛	qvik
煯	rifk
跙	jk
亝	cccy
磈	jlc
兠	kiyo
㭉	vm
㮒	mjy
莕	vmh
骍	gyb
磞	jdff
酧	jtab
嘂	hhih
婮	xjj
勀	jof
墫	ywjb
䄻	por
䉄	zsyx
箢	zazg
晿	kkk
檈	mltc
吤	hwo
㺿	usii
巂	douh
慽	inip
鬊	upmk
黭	lyrv
濋	emmo
瑵	uxql
䇞	zv
㰬	fkzw
䉒	zirl
䒽	vdxx
㶾	jtr
寔	akto
籞	zpzp
䘽	afo
㛠	xdk
憭	imkp
掿	bvbh
梣	mdwa
侹	oiyg
沰	ej
㬉	ktdm
夽	myc
蝆	lotb
㵴	enzs
逧	rha
䐗	fyk
瞈	kwcs
梇	muv
柹	migi
䖩	lei
惷	mke
䆃	wkap
䪞	tmot
椔	mcl
㮭	mchy
㻅	uwyc
濝	evwp
獀	pfix
渉	eopi
䠰	jvhu
㬐	ktpk
霃	reao
㾒	qxh
䨼	ufvx
峆	dwh
兂	sooo
蘉	vlax
玵	uv
㣘	pfh
磹	jjkb
譥	kqxh
㲹	eg
䘶	asrd
麿	qmmh
㖴	hvfo
觧	zfwu
琝	ukq
䚥	zfgw
緳	qbsp
䍪	wubw
䞾	yozg
䂝	jn
刢	wao
䎩	bwcl
㩈	bawh
栛	mfff
邆	ztha
䚭	zfvu
刕	sss
匴	szkv
脋	sssf
壾	yhws
䎠	gqtd
䉏	zzfb
䔨	vcou
洆	esrt
㛳	eadx
憁	ihxe
䎹	irk
慞	iykb
甛	vij
厎	tfnq
楐	mlwo
㴜	eqjd
椊	mqwb
掲	bkff
柍	mdm
襶	abln
曶	fok
刋	ibo
䎲	kg
柧	mc
髄	gfba
㝑	aq
釁	zyds
乵	ybd
蝷	lqwd
鬘	upkx
檞	mzfb
憃	mfe
敱	dthx
䇺	zthw
嫟	xsvh
愄	iltc
䘤	amq
傯	ohxe
㥡	ijfm
涖	eoy
貜	pkkx
瞕	kykb
褆	akto
塰	ezjy
洿	emyg
䀗	ksw
䍑	dxxy
筞	zam
袲	qzzc
籕	zmfl
蠺	tmtl
䍡	lqvf
瓳	jtiq
㰡	wozw
䈠	zryx
䒋	dmzj
榚	mwur
㬥	kddr
桻	mxb
廌	qvtr
鬛	uphr
枬	mfq
蜁	lzso
㴤	emqu
峧	dex
炠	rki
鞁	vlix
徴	pdux
応	qe
忀	pqhc
艻	vf
迯	zia
㡙	dhxf
䈳	zkss
垨	yab
㧹	bktb
炻	rjv
㮾	qscm
䨣	rvl
勶	pqcf
䍸	wubb
䄘	aeaq
媊	xwfo
妧	xyo
䢋	toa
䵉	qmmo
搄	bitt
㩓	fygb
䖢	lpi
硱	jhm
䔌	vkmb
姙	xoiy
掕	bywx
䎎	sskd
欰	ilzw
㾶	qgf
鄫	wlks
僐	owuh
腬	fcsm
㾡	qycs
竵	ytht
㧈	bg
渂	ekq
糂	rvwd
䵒	pwik
皔	kky
咢	hhyg
䤚	fky
婋	xing
醃	jtml
嶦	dzth
楳	mvm
㟑	dban
瀿	ezjp
冝	ak
麙	qvih
莣	vqe
㓴	tdmo
䅛	pkk
枛	mr
榽	mrcm
㖑	hnv
啠	zzh
䰉	upfx
㸀	rqhy
嵕	dxdx
蠠	tlll
脿	fuc
㓦	tko
㿋	qhhm
忣	igq
㟔	dwah
沞	etd
僙	ovlw
凥	jg
䴪	qvir
㕭	him
蹃	jvbh
莂	vhfo
傓	oqjs
雦	ouou
戂	iqmu
崓	dhj
㸰	baf
跿	jyo
䦈	uby
垯	yma
蝔	lifk
銐	tzon
䯓	gfyy
衐	pssy
㪑	mlix
凗	wdou
榁	maty
礈	jwpa
怰	iqc
螸	rhzl
睵	kbhn
罥	lhf
晀	kor
䕜	vssb
硸	jdty
硿	jawy
䐻	fjyb
唲	hfo
蜠	lhp
䠉	jah
噺	hymz
㪨	wuwx
䁯	kwhs
䄭	pib
儗	ofzo
傡	oyy
䨆	rxou
㬸	fvof
蓵	vbto
窼	awcm
檕	bkdm
㲞	qwwu
厗	tyb
眏	kdm
㢷	gdz
㬺	fwmd
蟁	sinl
廩	qqhp
㮁	mxbf
䎻	kfyh
煹	rvdy
袠	qimc
䁽	kchr
鼟	yhww
㮆	mwwu
萅	vndk
葌	vxxx
袑	ash
偀	ovdm
偸	owfc
㻪	uoug
㔠	kfwf
褦	acff
磍	jabh
㢮	gzv
㬳	fzb
㜜	xufx
攍	bqhq
㔩	fycl
皳	brqx
㭢	mtvo
䰢	lcpy
篎	zkpi
䔕	vfbq
螱	jypl
䪂	vlmd
髮	upbq
䪉	vlcr
亀	zkl
蓂	vake
挄	bpto
砎	jwo
鎜	fgxn
㟰	dake
䎴	kv
揓	bqzv
㭾	mjdd
㺤	pwwn
秪	pfnq
淲	eing
糘	rap
㒁	ohyy
㦍	ihhd
䖴	lor
蔵	vnis
㫰	kqsc
㽄	vwzq
砶	jk
醎	jtnh
蒥	vfsl
涹	epx
炪	rdd
漹	etor
㹅	bfxe
菆	vkx
㫷	vwk
採	brm
㔗	gof
䢿	axs
㡟	dvkk
砱	jwa
煋	rkiu
飬	wmqc
砇	jq
楬	mkfd
垶	yyb
㧧	bqcp
慬	ivhu
攽	wsx
㪟	qhkx
㹹	pqsw
䜪	rhg
澊	ewjb
㶟	ellp
㹖	bwmp
稥	prk
凞	wisr
䠒	jjf
彚	sakm
㦗	immp
秱	pdth
㭛	mzc
䐌	dvwf
㡖	dity
羠	wumg
疨	qsii
眆	kq
牱	bth
旉	bqq
䝗	pm
皏	kwv
㞴	dfn
抷	btit
䢀	bzg
唩	hpx
鄁	iyfs
衵	ak
歠	xxxw
㤅	soe
笁	zy
㧃	bii
杧	mq
盙	bql
䅪	pld
萀	ving
㧲	bam
䈄	zsrd
㿆	qpqc
砪	jjw
㷜	rqpm
䖆	vjtc
㼦	ygqq
镴	nchr
㻹	jpuq
畭	lwm
㐙	thwg
㬬	kkku
怾	ihw
錖	ipxn
䬸	tzxc
㓑	wywy
䐲	fssk
坽	ywa
湙	eqpm
澂	edtx
䓟	vfyh
徟	pfyh
绹	cfzd
祤	ass
㓘	gtzq
醝	jtwy
䐩	fdtw
䢒	exa
䀫	kwh
焅	rbh
㾬	qifk
恱	iwco
㭷	mlf
䙭	aavo
悆	wme
㪊	sihx
乑	pppp
㪘	whwx
蔰	vqjj
㴷	ekao
搝	bkm
䝤	pmkp
樑	mesm
竎	yv
䄋	aml
䈾	zmpf
萒	veco
䜸	thwu
㗭	hire
䈒	zbdy
槷	ywym
蓕	vmyy
垡	ony
姷	xbf
揇	bbdy
犐	bpwb
㑔	otd
歏	vhuw
㮘	mcsx
椦	mwmf
吀	hib
姅	xwb
敎	xbnx
脭	fhu
妉	xao
䯰	upwo
潠	ejjw
凐	wjy
㑙	okd
痏	qbf
摰	ywyb
磤	jzsx
骵	gfmt
㝖	azz
棃	pfim
攲	mthx
闿	ddsd
癹	zgxx
筗	zohi
䯅	gkxx
䇋	yzz
疺	qia
楩	motx
裓	anv
䯹	upsx
蛖	lnpq
㦰	wwnn
愮	irzd
峾	ezd
裀	ahm
㶖	eoir
䵏	vlwp
㥌	ifr
䇒	scsy
䦇	uwg
㙥	yehc
匼	swh
愡	ifxe
㳏	ehx
䅴	pbap
豙	yppp
㽥	lcsm
矟	csif
㗛	hzim
澺	eyke
䢶	ms
躱	idum
㶡	gr
襡	alfl
扊	qjrr
㩦	bouh
䃒	jtht
㖿	hks
靗	ufpo
䓐	vmnd
㑆	oj
㢏	qwfo
珄	uiu
醹	jtrd
鋆	yfwn
嫚	xklx
焄	sihr
姩	xzb
㗒	hqhc
鲄	lth
狫	pyf
弰	gpf
䍃	rzbd
笶	zzm
寕	atlt
㐾	oyo
槬	mmyc
捳	bztd
䕺	vpwx
罳	lle
㚝	moyy
䢍	qa
鞕	vltx
㽓	iuiu
㒱	wz
唗	hyo
獦	pvkd
羙	wur
煀	rjdd
璷	ubqx
觨	zfyr
孂	xzsl
棪	mrr
㸩	by
㝰	akaq
柺	mhf
隭	srtd
梤	mdws
冟	akf
狢	pxh
㒮	yop
㞍	jgq
纍	lllp
㾳	qwzx
㖌	oghf
㲦	bkbu
氁	uvkm
潏	ecsh
汓	en
䩁	ouuu
槩	scsm
隦	sjhb
㖶	hjy
㤟	hve
䒲	vxin
佁	och
妀	six
䕕	vekx
尛	ppp
塊	ylc
㚓	mm
俶	oipx
橻	msyy
茷	von
陚	ston
朞	vwf
蛡	lss
踂	jkd
䕨	vfwp
昮	kyf
鲹	lcmp
䂗	jf
舮	fqj
㩴	bkku
仼	ou
簃	zpzz
㢂	qih
躆	jinp
廻	hhg
帉	dws
雗	bkbu
牔	zbqb
歫	oss
䢤	pmqa
㸻	bczm
葞	vgk
羫	wuay
㻐	ucwx
迡	jfa
墂	yjyp
㐰	oh
祲	asax
㷶	ovir
㥂	iktb
濈	ehkn
唀	hpg
䩈	tlzw
凁	wmh
渷	eej
䁢	kqzo
窋	awdd
苉	vso
㪃	thix
垙	ypto
辀	bf
筩	zcf
醘	jtyl
㐑	xwg
㳺	ebzn
羐	vyzq
燑	ryky
䢟	qxa
䘇	qlll
瘎	qvwd
玒	uy
䩞	vlih
怢	iim
桘	mih
涋	eam
䏐	fsw
渟	eqht
炋	rti
㼁	uwun
稇	phm
粡	rdth
㪽	tkz
嘾	hjkb
晸	ktox
羃	lvkd
茰	vkx
㤭	iimo
靃	rouu
礝	jrtd
䕊	vqht
㜊	xjvc
㡵	qwa
叏	six
䠁	jccy
靻	vlk
漖	eynx
俒	oayo
萳	vbdy
媏	xdtd
枖	mim
䀸	bzk
㹨	pl
迊	tda
媝	prx
摚	bpay
㛖	xcwx
嵡	dwcs
奿	gqx
梊	bzm
泀	esth
襊	akkx
䄲	pdw
䙊	avad
岤	daw
耟	bwss
䟹	jrb
暦	tmmk
烠	rbf
篯	znn
㝧	axwy
䝊	ptso
炄	rsy
呭	hvd
䣸	oiyt
癝	qqhp
倇	oazg
燍	rvwz
㸔	iwbk
䊞	redj
鹡	rwft
黕	lyro
撠	bbkn
糥	rtdd
㤑	ibh
窧	awib
墴	yvlw
鋬	bzxn
徱	pjyp
䜭	iath
澟	eqhp
犿	pqi
䧣	sjyp
逌	ihsa
嶿	drtd
䠥	jrx
愷	idtw
栜	mmd
㳋	ezt
䃍	jwp
㘂	hwce
䔱	vbhk
䂊	csip
㯌	mpa
㱿	ydtx
㑛	omh
墐	yvhu
䗖	lvad
箄	zlb
麤	qvif
乪	gl
骃	ghm
谽	rhwh
遚	fixa
谾	rhay
焟	rvk
栮	mk
溦	edtx
蛒	lxh
毰	uyh
㣧	pcfd
䶆	frou
㢤	bfn
䙪	mxxc
䣫	jtbx
曣	kvhr
耱	bwqj
茡	van
灹	rin
䂳	jwwy
妅	xy
䊙	jtvr
㿪	ixgq
迻	zza
諐	ohph
櫜	thim
兙	job
䩧	vluh
䰦	lclb
㛆	xgm
镽	umkp
苪	vtdw
撎	byaw
㨹	bbbs
㷮	rvkk
嶀	dryg
兪	wfc
妐	xwc
㚻	lx
勜	wcsf
蚛	lhi
蘨	vrzp
慀	ircm
併	owv
墽	ykqx
奆	mss
眫	kwb
䃞	qhnj
帣	wmd
趂	yozp
浢	ethw
樭	mvwy
痆	qjf
䩗	vlf
仐	wbbb
䇅	yn
㢭	gix
㨖	btcx
趢	yosr
榘	zmsm
髍	gfqm
镚	ndff
諅	vwuh
㠗	didm
䟫	paho
䩰	vlhk
脲	fjir
嗐	habh
㳄	ezw
庰	qwv
蔉	vehc
豮	pbvd
蚷	lss
㺶	uwb
湨	ekm
㘮	yjq
朑	fvd
㑲	obdy
浤	eabc
䩹	vltt
篠	zoim
堼	yyby
溼	etcy
㖈	yfh
䙘	anip
孷	bwxn
鳠	lvox
瑃	umk
薁	vidm
眐	kto
崈	aypd
孡	nch
滆	etht
䧊	sbh
螎	ltht
㽀	wjtq
䧘	sjp
㳵	epn
锜	nmth
䁐	kvdm
埶	ywyq
焎	bzr
燪	rvfe
靷	vlgi
㼼	jypq
偭	otl
㘱	ydy
䰟	yclc
汌	ep
爒	zrmp
椑	mlb
仸	oim
髸	upvw
堫	yxdx
噭	hkqx
溊	ejyx
矆	kvox
蚼	lfh
髿	upei
䏌	wf
浰	epo
䰔	upfl
慇	zsse
虃	vewn
蜧	lqjm
陠	sbq
螜	yatl
湒	ehk
䣐	vdms
赯	ypqh
苰	vgc
暳	kbbs
捤	bju
櫮	muhh
簑	zqhc
䯷	upnb
㧶	bidi
壵	yyy
噂	hwjb
鬏	uppr
篂	zkiu
髪	upbx
㝄	qhnd
㺆	pgmd
呿	hyc
朰	mg
㠩	wdp
㯇	mouy
㿲	mthx
翃	bcss
䑡	fxq
屷	dg
䒅	fwmk
侁	obo
笯	zxx
枠	mgb
櫼	mwwn
尲	nwsp
潄	emhx
榦	bkbm
㽮	lllu
炗	vr
雮	ru
㳾	ewud
苅	vxo
圔	hycl
㹡	pqc
㫙	km
炲	rch
㗅	hjf
鱽	ls
㥚	ifw
䦿	shi
艵	wvzj
蠫	poll
㻌	uwm
曵	kfq
翙	dzss
㗤	niih
嗁	hzig
髚	qhdg
㟴	dlc
㕫	hq
穣	pevc
翝	abcs
箖	zmm
傸	omxx
㦄	qmme
伀	owc
璖	uesm
砃	jfq
塃	yvqp
塕	ywcs
翧	atks
捈	bwm
㟫	dkir
㶷	rfk
卝	ottt
畊	lv
懡	iqmc
翂	ssws
䊐	rkif
淂	ektb
㓻	ltoo
邟	qgs
脠	fiog
䵯	lyry
䘝	an
淽	evo
䓿	vchy
撍	bsok
㟚	mbxd
㭗	ml
呥	hdy
䊄	ygqr
臋	jvww
雼	rj
赽	yosw
䣋	irs
滶	eufx
㖖	ybh
㘧	ycsi
聕	kbh
瞁	kkm
畟	lwx
猂	pky
㠮	wpky
兎	ihoq
扡	bv
觺	fzmf
栱	mvw
粍	ru
柎	mob
欂	mveb
庽	qkdq
膡	fwmk
䟈	yobu
鸧	wggt
䂦	jwp
㵘	irir
厽	ccc
甔	ztwq
䗈	lqk
旍	qzwa
溝	evdy
㺘	pour
䔄	vrzd
叇	ycba
㛧	xdj
夿	mj
玼	uof
呉	hgtw
秓	pbx
呞	hsth
褈	aity
婔	xouu
汱	em
㸷	bsb
㮻	mxql
㸂	wpar
䐕	fhk
㣑	qbfp
㣂	gtht
䐆	frm
笓	zif
疶	qvd
蔒	vsir
蔢	veix
㓈	wj
㝼	ntb
褢	qlcc
漝	essk
䠜	jvk
炡	rto
㾗	qqsc
膎	frcm
㩡	bjjj
聧	kztm
鬤	upqc
酄	vhhs
㵐	etww
雵	rdm
婄	xyh
㟊	drn
䣇	brqs
湡	ekdq
䩌	tlor
䉘	zmap
㳭	ehm
暀	kpqu
毢	uj
㷠	rrzb
蚮	lon
娯	xhgw
椣	mdvw
筂	zev
璈	uufx
嶱	dvkd
㓭	kfwo
聜	kawy
朁	sosk
弴	gqhn
哃	hdth
䣢	bwvs
嬁	xztw
瞝	kqxc
㬅	klts
蛍	eal
垽	ezy
㚆	qkx
趘	yoju
趦	yowh
笌	zsii
䗺	iogl
㷆	rihb
㼠	aitq
㷑	rjy
㫀	kkz
䁏	kjx
壨	llly
㯣	mvwm
滛	erzd
䒪	vcv
㟽	djyp
辿	da
佲	ozh
惖	kfoe
荶	vhwa
㫞	kdx
胾	bdwn
㵵	ekxp
㪴	yowb
䓨	vazd
䖌	ingo
撀	yjgb
棑	mouu
䗲	lrzb
硑	jwv
宂	ag
䏩	fwh
峠	ditq
碏	jvk
珟	ugtz
堎	yywx
扥	bin
倷	omyp
醔	prjt
䧱	gou
畍	lwo
槀	qhdm
㾅	qigi
碤	jvdm
颒	irvd
囩	hyc
䅔	pcl
剉	wwyo
娚	xlf
袊	awa
盚	brql
鞈	vlwh
㕤	hg
艂	fxb
扖	bw
㣺	iqqq
䀞	kwb
琙	unht
㤀	wde
囶	hwy
㫥	kzh
㰶	xihw
楄	mqjd
竒	yhi
庌	qsii
䒘	vxxx
暔	kbdy
袯	adxq
煔	rrih
筯	zkf
嚖	hbbe
鬁	uppo
湶	ekir
㐷	og
臎	fssb
葓	vevw
㱙	tztg
懽	ivhu
㯱	thim
䟙	jns
䄖	awfo
㡊	dzf
箾	zpfo
彉	gvlw
劸	yyf
䔾	vbkd
惈	ikm
幇	yybd
㹴	ptkx
㽜	zgl
崻	dpyb
䈹	zaok
掯	bof
芚	vnd
喩	hwfc
碝	jtdm
饸	zwh
懃	vhue
祘	ypyp
焲	rqoq
螡	qll
皊	kwa
莄	vtkx
秶	wzwp
歔	inpw
庝	qxw
䣝	jyks
㯨	mjr
䓃	vhj
蓳	vvhu
窮	awig
㨤	bsou
㦷	cfn
䝟	pbsm
嶣	dour
泬	eaw
葨	vltc
㧫	btd
䚘	pzfy
䨪	ryky
㞵	dq
袝	aob
㤆	izx
蟫	ljkb
㼎	cex
袻	atd
㻴	uklx
䇥	zto
尠	vwdi
䀂	axl
熻	rwhs
塴	ydff
㕴	hag
䙏	abqb
嚰	hqmj
勧	zbif
屼	dto
㠋	dhhg
斶	zlfl
磼	joum
䞨	yoyy
㻡	uvdm
䟢	jzp
捛	bhh
倕	oity
阹	syc
栒	mfk
㧬	ygqb
猺	przd
裺	aml
侟	obin
妼	xei
捾	bah
蒞	veoy
瓡	ywyc
䞰	yoyp
蘳	vvly
塆	yqpg
撨	bour
䏲	fwgi
漒	eghl
竤	yabc
皷	yhwx
㠔	djhb
惏	imm
㕙	cwxq
㗸	hpzy
峹	wmd
萮	vwfo
燱	ryke
撱	bsbf
螶	ssll
囨	hti
祏	aj
㮰	mhxf
㺻	utd
䙅	ajx
㿠	kpto
焩	rff
彥	qxtp
䧼	bhou
褯	aqvd
㴻	ethb
粖	rbw
㦪	iuhx
禆	alb
㒸	wp
趍	yozz
㮛	mkto
䏰	fsqe
耤	bwvk
䬥	nwqc
㐤	gbkw
㞋	jx
坔	iry
㢍	qvdm
㷏	pzbr
㩽	mhbx
摓	bxba
莌	vwj
斿	qzn
舿	fmyg
漮	eqbr
帒	ond
莵	vilq
潖	euuj
悪	thoe
㞙	juir
㰀	mpfr
䕎	vktl
蕅	vekq
䰍	upmr
㵢	erl
埧	ykw
蒰	vfgx
弫	gs
朣	fyky
踋	jycs
宯	ayn
䃾	aif
坢	ywb
弖	gt
爼	xxk
裈	aab
傏	oqbh
㱒	oth
盶	kyo
䨔	rpto
櫐	lllm
糴	wrsu
鬾	lcbx
䉡	zqht
䨍	rv
剭	jtco
酙	jtwb
㖃	hzth
㕐	tffr
瓗	udoh
碻	jqhh
庂	qw
㒬	you
鞹	vlqs
咰	hfk
圶	my
槖	yajm
㶬	rbw
祻	ahj
㫋	qzdy
䞞	yogo
旾	ndk
珳	uqp
涒	esih
髱	upfj
朜	fqhn
盵	kzg
毈	fqsx
䕟	vzyw
䇐	ybr
鞰	vlkl
㤓	imt
㚘	mm
隺	aouu
㒥	odbw
㱶	tzyp
塧	ywwl
雐	inou
溂	emho
㤸	iyp
陑	std
哻	hky
㑍	obw
岝	dziy
䏞	fbw
卂	gbbb
㞫	da
禒	ajp
㚨	xgb
揰	bity
䯈	gfyo
傁	ofix
㜅	xqcl
渰	ewhv
䇗	zwc
㕿	ph
蜲	lpx
㕇	ty
俽	ozzw
㐲	om
莡	vho
邫	bhj
㩯	bzjp
耝	bwk
惥	fwe
敄	csix
秅	pin
壃	ytlt
姇	obx
姴	tzox
㐖	yhd
䀔	ksq
矅	kssu
櫱	dihm
煕	sigr
螪	ledh
坧	yj
㧙	bei
萻	vyk
踿	jpr
坃	yyo
嗴	hwuc
嵀	dmqu
媔	xtl
嫕	xsze
禔	akto
㤢	ibf
䞹	yoku
䈍	zqk
旵	kd
㞆	nmth
䏧	fzz
愨	yate
㴗	ejx
懲	pdte
劦	fff
䊂	rmd
屪	jamp
䞌	dij
䭲	pkmh
朻	mii
㫗	kn
㷽	rwuh
髛	qhdg
䞕	yprd
剻	dffo
㰽	skxw
崰	dcl
侺	odwa
齉	kltc
䝘	pgx
岏	dyo
梩	mky
槣	mamh
㨲	bvam
醰	jtjb
涃	ehm
矔	kvhu
䍯	wuzg
滍	edtl
暛	kwuy
肕	fsq
巬	ygm
翐	ssim
歩	opi
佊	oix
惞	izzw
婩	xdty
抴	bvd
潧	ewlk
褼	ajmj
䈛	zidx
娨	xky
䆦	awrr
㝹	pizq
蟟	lmkp
橵	mvfx
㵙	eyhh
䶍	tcyo
䍅	zbda
喿	hhhm
粺	rlb
㠳	wd
㫬	kfk
懯	bqqe
獿	ptkx
姤	xzth
咷	hor
笲	zcv
聐	kyh
㴠	eshd
薎	vlan
笖	ziqw
峘	dtkt
刡	sino
徸	pyky
㾯	qltc
㩄	bdle
㾨	qmth
厬	tkxh
厒	tzbd
彋	gltc
鞞	vllb
椵	mjyx
㴨	efwm
壴	yhw
㹤	pyc
棳	mxxx
憠	twde
㚶	xh
蓎	vqbh
䵤	tvlr
硘	jhh
濢	essb
鳋	lxql
㰷	tziw
圐	hlq
䘠	abx
䠵	idub
樥	mvxb
搉	baou
腯	fzbk
榟	mayb
聭	klc
蜅	lbq
妕	xhi
䨷	rmmx
䉎	zpam
䆙	awto
炿	rifq
憆	ipay
㩁	baou
㩏	blyr
椆	mfyh
䂡	jzt
䔇	vdtw
濪	eufj
㰝	sizw
䐈	fbk
䅫	pqkp
鍙	evwn
莯	vem
䘒	ilcx
䤑	jtvw
䎜	yiyf
刦	yco
掻	bxl
娢	xwah
姁	xfh
抂	bu
㗊	hhhh
楌	myip
㣜	ptvo
忼	iqg
衂	ilsq
䖮	lidh
焿	rqsw
抳	bjf
䀛	kfo
晅	ktkt
悮	ihtm
屴	dfff
霐	regc
璏	ujtf
䖑	ingk
㒏	oavw
蝳	lujw
欻	rrzw
㽗	lw
逫	xxxa
忷	ixd
䖦	ldd
抝	bcs
㪬	ssox
荘	viy
劮	imf
㲟	vdmu
㬀	kqhn
㙄	yify
䎮	bwej
杹	mof
鄋	fixs
䇾	zuh
㮗	csim
蝂	lzzx
䁅	knl
聉	kdd
疷	qfnq
忛	igq
䠻	idug
㧾	bfoe
炛	rof
㾠	qpu
䎑	sssr
壉	yinp
䍍	yatx
媆	xtdm
蠤	wjtl
膤	frs
㔉	jilo
桿	mky
婏	xzhq
㺍	pazw
䨧	rywa
殀	tzim
㙗	yltc
忩	wce
吘	hzb
昗	ke
兒	fo
㟱	dwur
搲	bawc
滳	eedh
醜	jtlc
氿	eg
䒀	fzob
䧔	swae
楁	maxh
礽	ag
暡	kwcs
㬱	bobk
寈	auf
庯	qbq
藨	vqvr
㥜	ilf
㲽	esq
䇖	zfi
狥	pfk
絭	wmcp
䏶	fify
硽	jml
晎	kvw
忞	qe
䎥	bwrh
枟	myc
峫	dsis
㣩	pmm
腷	fthl
䨻	rlrl
㖕	hyb
㡹	qk
枍	mwg
異	lvw
㶺	rtmh
榹	mzig
潹	emmm
㰌	mrou
刐	fqo
曽	wlk
咞	htv
㟕	dhwb
蚒	lfq
䍝	lirk
聢	kato
䨎	rgc
塬	ytkp
䂋	jbcm
㟟	dvwg
蝋	legb
㥲	bkwe
䏇	kjyp
暚	krzd
偄	otdm
幋	fgxd
㐍	rg
玃	pkkx
奜	ouum
瘨	qbkw
汑	ein
蝐	ldyk
㜨	xjib
妺	xbw
㓯	clo
㖹	hwsl
䧆	svw
欴	qscw
眅	kzx
偧	omzz
䪅	vlll
䖔	ycig
䇰	zsrt
蛿	lwah
硲	jrh
㱫	tzml
冭	mw
尩	wou
夘	zsss
䅉	ptp
䂽	jikb
睭	kfyh
㬦	kvox
敤	kmix
酫	jtwu
瞚	katw
粶	rsir
埖	yvof
髣	upq
夡	zzyh
跀	jf
㲆	yjga
㯀	mqzo
愗	csie
戣	ztmn
棥	mxxm
㐂	nnn
蜛	ljj
㾹	qofm
箁	zyh
㔯	sgh
塺	qmmy
䤄	jttl
刴	gmo
褔	athl
䔬	vlvw
㸛	zsh
攛	bawr
䨃	kaxu
岥	dix
捸	bbr
睤	klto
嶍	dssk
㛇	xqy
㼏	rxc
䖛	ingp
㬓	kjyp
㐳	oto
堒	ykif
䁬	kwlk
㳎	ecv
檫	mazp
䄩	pn
稕	pqhn
眗	kfh
䑋	fqhc
匂	ff
樆	mqxc
惁	mze
憼	vfhe
烔	rdth
枊	mfs
埇	ycf
䙗	aedj
㝍	atgt
晻	kml
洤	ewu
佒	odm
吪	hof
烸	rzjw
㮞	mwzh
㼽	mxxq
夬	swww
洦	etk
洝	eax
䆹	awyy
䆔	awhi
洘	eytg
炐	rb
欙	mllp
㺩	uii
匉	fyw
洺	ezh
裠	sihc
儶	odoh
垀	yiwb
酺	jtbq
喴	hnih
眜	kbw
磪	jdou
淿	ekd
䗮	lmxx
㛾	xnih
矱	zmvx
䒡	vgi
㒡	orzp
娰	xoiw
埫	ypdh
甡	iuiu
㠂	dufx
䁗	kdtw
窤	awkf
㟃	dsth
桚	mcz
䁵	kltc
㯉	minb
硦	juv
烇	rwu
㔸	szig
嬢	xevc
殗	tzml
狓	pix
咓	htiq
䆊	piyw
鞙	vlhf
㷣	rwub
㒨	ozyj
墸	yvyk
㬚	kqcx
邥	aos
丼	vqqq
镃	nwcc
抍	biv
蕵	vzwc
豰	yatx
摤	bmxx
㤉	isii
㸉	ybrr
恟	ifxd
悧	ipo
䑚	ijf
硟	jiog
䣬	jtn
栨	mwzw
丳	hho
㕟	idx
㬌	kqkp
螋	lfix
䍘	lr
䨮	rbbs
䤈	jtwl
䑑	spwm
癕	qqcu
䑪	fwh
殜	tzvm
㭀	fzyw
樼	mjnn
糢	rvkm
䨜	rff
嫀	xmp
㱤	tzmz
䧍	srh
畾	lll
䪭	ykyk
愐	itl
䇷	zhfo
䯐	gfdw
㻜	uwwo
撉	qhnb
䗜	lfsl
䆲	awqr
柫	mgo
敊	ipix
筸	zky
邔	sis
狊	km
㚇	xdwx
㨬	byhc
瓭	aotq
丮	gbbb
㰁	mjjj
㖧	hfnk
䂲	ycfj
䗋	lvm
㪺	mkkb
㑣	omm
䓭	vxmo
㻂	uwv
牃	zvdm
搨	bkss
祡	ofyp
㮎	mtil
㴏	eawu
䤖	jtkr
鞎	vlsc
聛	klb
茞	vs
恎	itcy
愭	iyfk
㵇	eijv
旛	qzil
㴘	edyk
㴲	ezig
麕	qvip
㕄	ttc
媩	xjf
㤱	ithw
丏	tds
㙼	ylll
鬷	thdx
隓	sbyy
㚡	mthh
㙝	yfff
冓	vdy
㙩	ymkp
䠖	jwzh
匞	sy
皜	kqhh
㐺	oow
翆	ssgb
姼	xzz
歋	zinw
䅰	phme
聎	kor
䯦	gfvq
䢗	hva
娏	xnpq
蒄	vayb
猳	pjyx
㭥	mzd
䛐	sthh
䘲	asax
裄	apy
䢲	kkoa
㪿	ddz
耎	tdm
䯴	upgx
悑	ibq
㚳	xfh
衎	pyy
㦴	nxh
箌	ztco
㵫	ennk
檹	mqzh
窚	awnf
䰁	upsr
㐞	vwg
阘	dkss
濌	itkk
娝	xtih
麃	qvir
岉	dfo
㙳	ynie
嶚	dmkp
磄	jqbh
䇙	zgi
豖	pqqq
垎	yxh
淗	efr
憛	ijkb
㙰	zfsy
涆	eky
裗	aqcp
豝	pj
淐	ekk
掶	bqsw
尗	ip
㴩	echj
躵	idue
滘	eawh
眮	kdth
䏒	fz
䢩	uhxa
猠	pdvw
䐚	fscs
梄	mjt
琸	uikb
茥	vyy
䍲	wufo
帞	dtk
叝	ycsx
辝	chyb
觬	zffo
劀	csio
颋	iygd
萓	vak
靑	ud
垝	yztg
罜	lqu
竝	yy
腄	fity
玞	um
珹	unf
悘	szme
䓌	vye
䵓	pwib
㖀	hb
胈	fbxq
羕	wuqr
髞	qhdm
殥	tzaw
䈖	zpwb
㜩	xidm
㧢	bhm
㜍	xqbh
筥	zhh
靣	thh
袶	axb
嵒	hhhd
廈	qtkx
䈤	zmv
玅	qcpi
䠅	jhp
恦	iidh
籤	zwwn
俲	oexf
㕍	tou
䉉	zzfc
瘝	qlir
蔍	vqvf
䢻	ss
醸	jtec
㑵	oqzm
晫	kikb
唅	hwah
皁	kb
㺟	pssu
帍	qjd
䦋	uufx
棦	mzsi
㛯	xzhf
寙	acc
漽	ejib
喢	hibf
砽	jf
䗎	ljy
垕	zthy
庪	qbbx
枹	mfj
奻	xx
㛬	xywy
䘹	aqwb
嫎	xeaq
飺	ofwc
捇	byp
㭸	mzhq
単	ekb
鼑	ikzz
聇	kto
焤	qobr
玗	utb
㾎	qigt
柮	mdd
媷	xtyb
怳	ij
淉	ekm
獜	przb
䢠	rva
岄	df
䍻	wujw
珚	uhm
㽈	fzmq
䅽	yjgp
砤	jzv
䒏	wlkj
蔖	vink
䒶	vkf
晗	kwah
臿	ibff
㝬	abhm
弮	wmg
珓	uex
蚇	ljq
珫	uqco
㒆	owhs
墪	qhny
揥	bead
㭞	mpif
蛥	lzz
勻	fy
靪	vlt
畐	thl
䀁	bfl
㶭	rcf
呾	hkt
恘	iom
䖯	yyl
嵃	dyip
䕩	vmmp
萡	vek
踇	jzjw
睈	khu
歀	mypw
荋	vtd
豦	inpp
㭬	mp
湀	eztm
䁞	wwwk
粄	rzx
菻	vmm
摴	bryg
韾	yjgk
㞒	jk
檧	mvfe
㼴	kdiq
㛒	xthw
㶚	ejvf
柛	mki
隌	syk
㤌	iv
貃	pk
祦	ahtm
渳	egk
腅	frr
粫	rtd
㴆	esad
衕	pdty
叓	thix
舼	fvw
匔	fidh
甞	pahv
㥑	tkae
㡑	prd
䜼	csiw
盄	gil
趛	yon
䜮	rhab
橎	mirl
侒	oax
袃	nsqc
恵	tle
薡	vkzz
饻	zqc
晲	kfo
㪉	whx
唶	hvk
痺	qlb
袕	aaw
䐵	fvlw
眡	kfnq
葐	vwsl
昹	kqsr
㭒	mh
鲴	lhj
䓛	vjdd
㓜	cs
㪣	qhdx
莃	vxbd
敀	kx
焷	rlb
㝐	awc
䚢	zfvm
湲	eryx
㞄	nml
眳	kzh
㤚	ipy
䖸	ibnl
䠍	jjyx
鼛	yhwh
㬿	fqhx
叿	hy
䍊	zbdx
矻	jzg
㭪	mbq
䯗	gfiy
晩	kzlo
䀧	kvw
昅	kgq
㪕	ikbx
籾	rsq
䢭	wuwa
窫	awbm
癦	qlyy
㪜	dtdx
㩔	bjvx
蹢	jedj
厛	thz
䈅	znht
昩	kbw
蒤	vewm
佽	owzw
鼭	fryb
杢	my
㬴	fvw
靾	vlvd
㹒	bpwm
馣	pkml
稡	pqwb
㰺	jysw
帨	dwj
傞	owuy
刯	tkto
焮	rzzw
怬	iho
儤	okvr
朾	mt
菉	vsir
晠	knf
䨩	raki
砊	jqg
䄇	ahu
礃	jpab
㰥	vdzw
䚛	zfbh
㹁	bqhp
蜤	mzl
㦜	ivox
荙	vma
盕	egql
桬	epim
哠	hbh
彞	srcv
鲖	ldth
疊	lllk
㤿	iml
冾	wwh
羜	wuat
杁	mw
昲	kgo
後	pcx
秮	pch
㿊	qsok
欌	mvns
䗀	lywx
廦	qjhb
抮	bwp
梙	mhhi
熀	rkpo
䅏	pju
㻮	uzyp
蚉	ql
䘼	aazg
䖊	xing
䇤	ztdw
䈲	zfgx
㡚	dvdy
咺	htkt
㷁	rcf
㫴	kyn
湹	etky
怇	iss
㼢	sihq
㹈	bwxb
㢠	dhg
㦉	iyaw
㡃	dwdp
蒩	vpk
㞰	dzb
䣻	jtwh
㩲	bvhu
䙩	avap
䄷	pj
衱	agq
怺	iqsr
抩	bdy
蔴	vqmm
垇	yigt
鞤	yybl
蠍	lkfw
㧇	bdt
䝑	pyky
竮	yjwv
辦	ybfb
㶇	emvw
啘	hazg
葪	vzfo
蜬	lsrd
楰	mfw
妎	xwo
際	szyp
䯽	upyh
煐	rvdm
臓	fvns
橝	mjkb
靘	ufzj
穜	pyky
蠄	lwqc
痋	ql
䨑	rmg
㪗	yhix
煫	rwp
噿	hssb
豍	thwb
鞇	vlhm
㝢	aild
㨙	brcm
䠼	iduo
㖎	hfwo
癄	qour
唭	hvw
㭅	mu
澙	eftr
瑧	umim
剎	xmqo
徣	pvk
䐬	fvkk
煚	kssr
蓺	vywq
靬	vly
䇲	zmw
坋	yws
徥	pkto
豈	dthw
倐	oixr
蓨	voif
㷖	krsh
妜	xsw
呡	hsin
欔	mkkx
罶	lfsl
䌶	cbi
㶳	br
㵔	emyk
雸	rv
䆒	awgq
啂	hrnd
犨	ouob
釆	ir
倄	oxbf
㥺	iycl
祌	ahi
炥	rgo
㹯	pom
竲	ywlk
搱	bjyb
䣌	qfns
㳱	esk
赸	yod
鹀	ywwt
榢	map
湕	ebg
䀾	jxk
蠯	qlbl
㗼	hpww
琂	uuh
逰	bzna
夵	mp
瘷	qmhx
䟂	yokx
僽	opre
粚	rzv
璴	ummo
㗟	equf
嵏	dxdx
㗁	hhhg
哤	hnpq
梠	mhh
䌓	zjwp
劵	wmf
豼	pif
㼊	ndc
㡶	qhw
㵃	elaf
䪡	igit
䅞	pktb
皗	kfyh
僡	otke
婘	xwmg
㢿	gosm
䒺	vcp
䆛	awhn
㓺	inqo
褍	adtd
粈	rsy
汭	edw
寍	ael
笽	zl
痷	qml
箚	zwho
荝	vdo
巻	wmsd
豩	pp
䓻	vayx
㟎	drx
篽	zpzs
枤	mm
籺	rzg
峍	db
彮	arhp
璚	ucsh
㑁	odd
嶭	dihb
畺	tltt
䣧	jtn
䟕	jxq
毧	unb
䘪	aqco
濏	euui
翾	lths
㺂	pnih
仱	owa
㧋	bm
䩂	tlwa
乼	equg
䩛	vlei
㕋	tn
趗	yoho
汅	etg
暟	kdtw
蚳	lfnq
翪	ssxx
塣	ehuy
蒁	vmqa
祇	afn
狆	phi
䀢	kzm
卙	vwdb
哫	hho
穋	pssp
伅	ond
㓌	wwu
汸	eq
萷	vpfo
覇	jvlf
捄	bbrq
庴	qvk
琓	uayo
䟌	yobu
妡	xz
桸	mxbd
婈	xywx
脽	fou
槄	mrf
䂷	jibf
胕	fob
黣	lyrw
壂	jvwy
爮	rfj
炶	rih
㧝	fhb
椼	mpey
濖	elyk
㖚	obhf
墔	ydou
㝇	qhnn
㕂	twa
翋	ssy
䂪	jor
瓨	ytiq
涙	eqjm
䩢	vlbz
璪	uhhm
淛	ebdo
瑫	urf
栿	mom
䣃	ztos
㚯	xgx
搻	whbb
赪	ypid
䣞	hhws
朆	wlko
㳩	eyfq
蜺	lfo
溔	ewur
䯩	qhdj
雱	rq
畣	whl
痥	qwj
㜿	ncsi
呚	hx
甈	kmtq
扝	byg
㥫	iqhk
陹	sivk
㩝	bqhp
觠	wmzf
㟨	ddtd
㵌	epzk
搚	bfff
醏	jtyk
㫽	ksir
翯	ssqh
簕	zvlf
圂	hp
㨧	bcml
䀈	scsl
䯛	gfag
㙋	yvw
䭌	jfwc
媮	xwfo
䒉	fzvb
摗	bmhw
䩐	vlzg
㽳	qtb
稊	pwgi
芀	vs
䈡	zfxe
廋	qfix
祅	aim
䔦	vmzw
隷	yypr
橕	mpai
娫	xiog
棊	vwm
䐂	fsir
㣢	pwgi
㘢	hpto
舗	wyhq
㪱	qzdm
亅	iiii
䐑	fvdm
嫬	xqvr
瓖	uqhc
谺	rhsi
䜳	thwd
䀅	ayl
㵻	effx
焀	rrh
腣	fead
䵡	tmlr
樔	mckm
拠	bxg
鹯	qhht
㽶	qsd
畗	qhl
㘻	yhm
鹝	thdt
䵽	yhwc
烎	tvr
淧	eaei
䝔	pvhu
虆	vllp
湇	eyf
曟	kkkc
噇	hyky
浧	ehu
㻓	ukx
滃	ewcs
栣	moiy
䐞	fgww
猆	ouum
髈	gfeq
虸	ln
墯	ibyy
䄝	amf
虴	lin
堏	mqy
蒈	vifk
滺	eoie
㸗	wxdh
䶇	frlf
勭	ykyf
䙆	aztm
涼	eqhp
箈	zech
兝	jows
眂	kfn
楈	msof
瑮	ujm
豻	py
篜	zsrr
郖	thws
惼	iqjd
䩯	vlst
㷹	rvib
撜	bztw
炁	sor
䴣	qvib
䉛	zidm
浄	ezsi
淔	ebk
櫘	mbbe
㑠	ooxy
澴	eltc
呩	hyp
藯	vjye
䊖	rbdy
綤	shsp
㸡	zbw
幧	dhhm
䶀	yhwh
䗄	lwxz
漌	evhu
軎	bkh
㛂	xzj
鳒	lwsp
畑	rl
蛜	losi
哊	hbf
湤	eqzv
韨	bsbq
䊤	rjkb
崌	djj
㣕	pm
㘵	ybd
㢩	gfq
䃚	jqzm
䣙	dffs
浵	efqp
脵	fhtm
寲	afzo
愲	igf
粷	rfr
鲊	lziy
骭	gfy
犱	pgq
㳟	vwir
毉	szmw
韱	wwon
㽽	qj
䟾	jxxx
㗡	vogf
芕	vz
漅	eckm
㚊	zzqw
䰛	thdq
仮	ozx
泃	efh
恇	isu
蔛	vzfb
㺲	usy
嶟	dwjb
歜	lflw
麐	qvih
㨵	bwfs
婫	xkif
䪨	ykfq
朘	fcwx
㡿	qwd
䓶	vmho
淍	efyh
㻉	uop
㘩	yif
礕	jhyj
曈	kyky
嶖	dwhs
㷪	roug
㗖	hrf
酠	jtth
蚸	lzq
䗒	lwp
㮩	mke
藊	vpqd
鳤	lzah
篫	zygb
佹	oztg
粩	ryf
䅂	pxh
艔	fqvx
髼	upxb
鹛	jkgt
噀	hjjw
蛪	bsl
稜	pywx
䁌	klf
貕	prcm
谞	gsof
䩴	vljf
㞇	nltc
熛	rjyp
泚	eof
趞	yovk
䥅	buun
虭	ls
苃	vtx
䌻	css
蕯	vsxu
㼸	arhq
犂	pfib
䄬	pv
鄍	akes
崡	dsrd
泑	ecf
蚟	lu
湝	eifk
稯	pxdx
慃	iwcs
㤗	mp
祪	aztg
䊍	pfir
鹔	bowt
崳	dwfo
歳	onip
趉	yodd
㩻	ztgx
槑	hmhm
㢉	qpin
瓁	uvox
礚	jvyl
䆵	awwk
樰	mrs
蔏	vedh
䞣	yozq
亣	qo
扏	bg
㗘	hbqb
煴	rkl
㜓	xvwh
㦀	ixba
髵	uptd
䞬	yopg
䝆	fop
帄	dt
㞕	jwf
㱯	tzdw
㿁	qkmb
䒫	von
醡	jtay
䩝	vlc
䌘	rxcp
喅	hky
膰	firl
蔩	vatw
䉠	zpdx
㹝	pfn
珷	uton
㗳	hzwh
䧂	ssh
㢣	vfhv
揬	bawm
馝	pkei
㸾	bsqe
㜁	xmkt
贠	cd
媠	xbyf
熁	rfff
姠	xidh
㨄	bfyh
詧	zuh
郣	bans
䢎	tva
㙖	yild
㤥	iqcw
佅	obw
䀽	kiog
㪶	tkwb
煾	rhme
䭱	pkr
瘔	qvj
䏤	fsth
揟	bsof
婝	xato
觕	bzf
㱄	lyrw
珘	uf
㥈	dihe
卪	sqqq
坘	ytjt
篏	zvzw
穕	poum
覈	jkqx
莝	vwwy
姞	xyh
佫	oxh
逓	zyda
䓾	vepx
呴	hfh
䞚	yobx
䃺	jqmu
䓈	vpgx
浂	ewm
圲	yib
獞	pyky
浗	ebrq
㱋	rouw
蔁	vykb
䁉	qjnk
珤	uzbd
簰	zzlb
瓲	tigd
氺	irrr
菒	vkm
㱖	oqwb
䯌	gfjg
躷	idux
遆	eada
㗪	hofp
孃	xqhc
㞧	dg
㾓	qhf
瑂	ujk
臶	tcyn
苐	vgii
埳	yzf
㞪	sd
䈊	zywx
禋	ajy
㤳	itih
㿙	qllm
㳨	ectz
楤	mfxe
甅	tigy
岼	dyw
䏛	ffw
娦	xztw
䗵	ltlt
魒	lcjp
㑾	ozuh
姾	xwu
暬	ywyk
㜖	xvkk
胢	fth
䟦	jibx
䙴	jmj
䧴	bxou
䃰	jazp
禙	aiyf
朄	kiml
㤦	ithx
葅	vwwk
㾲	qufx
胻	fpy
厈	ty
㒹	bkww
愥	ivdm
僕	opwm
㼫	kmtq
㳖	eqc
㸬	btd
潒	ezhp
耠	bwwh
朷	ms
㐗	yfg
舦	fmq
娸	xvw
倠	oou
杮	mtd
㶦	rcsi
㑒	whw
姰	xfk
䏭	fbw
梺	mmtq
暆	kqzv
䆮	awex
㚬	xfw
偞	ovdm
䭁	bzwc
皘	kuf
㙁	yzjw
韄	vlvx
碨	jltc
䘜	ad
梶	mju
䄠	aqht
翇	ssbq
䓑	vetv
㮷	mnqk
栺	mfk
琯	uah
䏽	fyh
墡	ywuh
楘	csim
扄	qjih
岋	dgq
喛	hryx
筬	znf
䃿	am
㝵	ktbb
飔	gxle
懪	ikvr
䇄	yzg
㠷	dgq
烪	rwm
㕨	hgq
㛙	xyb
癿	kd
䞑	ypy
䧸	jou
叜	arx
㱨	tzao
衉	ilxh
蠷	lkku
䜥	gktg
枴	mhs
䃉	jsik
暍	kkfd
伮	oxx
檌	mlou
瑔	ukir
熷	rwlk
㚜	mnht
㕸	hy
僪	ocsh
磇	jhxf
侱	ohu
疁	lssp
峵	dabc
筽	zhtm
䓤	vfoe
㝣	absm
僸	ommp
裞	awj
㯼	mvyl
䂔	zmyy
㯧	myoh
踸	jvwd
嚑	hitr
㥕	rre
圤	yi
㕱	hnq
挊	bitq
㧌	bu
䔔	vyko
矦	ztzm
㫅	qwyo
倢	otso
塂	yvwj
蒢	vswm
寃	azhq
敮	ibfx
煣	rcsm
㞼	srd
糓	yatx
㿮	dmix
掵	bwhs
㒄	ozmr
䁹	kjhb
囥	hqg
䟯	jij
俛	ozho
骬	gftb
隁	sskx
劙	jplo
烼	rp
㫨	kax
䩅	tlix
捬	bqob
弙	gtb
拀	bj
亽	wq
㡅	dzz
瞦	kyhh
災	cr
亊	twb
枓	mwb
喒	hxik
㘆	hyhy
嚚	hhsh
冸	wwb
䎓	ssik
嚃	hlia
悊	bze
皩	kuko
袎	acf
罒	llll
黵	lyrh
㽍	vtiq
荲	vky
䕭	vywr
䞤	yofh
橤	eeem
稸	pqcl
艆	fqsc
袿	ayy
㨾	bwur
傆	otkp
㮍	wfom
襎	airl
荂	vmyg
䎈	sskf
褜	ffjc
睠	kwmg
䏉	kkcr
蒫	vwuy
圫	yin
㲛	zmhu
㦓	izmr
燚	rrrr
馜	pkjf
萪	vpwb
笚	zki
揻	bnix
䗫	lqmm
衼	abx
㜲	xqhq
罠	lsin
䎚	ssbe
㼜	dmtq
㺷	umq
嬍	xdtx
牫	bn
蟍	lpom
㯬	mmbg
冦	ayox
萛	vkv
崿	dhhg
囻	hsin
㨒	bmyy
㾁	qmq
䀰	krh
惄	ipxe
霩	rqhs
㔴	slvw
摾	bghl
䑵	fdyk
㝙	autw
燫	rqwp
衪	av
碯	jchx
桯	mhu
熿	rvlw
礨	lllj
㻥	uwjt
䅧	pyk
㫌	qzto
躮	idus
㯕	mvwz
㯵	mviy
倽	owyh
懇	psce
鞧	vlwt
伓	oti
竨	yikb
䉵	zkmc
卼	tozg
䰬	lcch
䗤	lqbf
㲔	ybu
䎵	kei
僯	orzb
斞	fwwb
㮄	myfq
睂	wwik
潵	evfx
窏	aweb
禞	aqhh
秲	pyb
㫸	ktso
蘛	vvwf
倴	ombv
㮼	mqjs
惒	phe
䞵	yoxx
㷝	rawm
皅	kj
䄒	awae
皻	inkx
岰	dcf
碶	jbsm
凲	gwsp
睗	kkfo
䟋	yozh
飡	wwqc
蒏	vajt
䟰	jpy
燣	rqhp
箯	zotx
䔰	vatl
㧯	byf
擉	blfl
㷊	mmr
㮵	mqzq
囲	hv
㢵	gwh
襮	akvr
莈	vegx
䧐	sqhn
䁫	klyr
㻸	usok
廄	qscx
䧉	sky
蚿	lqc
䒜	vb
㵧	evkd
䟝	jgx
嚞	yhyh
棜	mqww
穄	pzyp
䔁	vjm
菮	vqsw
㢺	gyx
㻢	uqzv
㪠	wspx
㨚	bvfk
塅	yzux
忰	igb
欭	hmzw
趮	yohm
㭣	mdh
㓉	wij
礇	jidm
趠	yoib
茀	vgo
篍	zpr
羨	wuew
攕	bwwn
亁	bkyg
䖳	lain
㓐	wywy
雥	ouou
柊	mxw
琕	ulb
㬻	fvqp
㧭	ysb
菞	vpfi
葲	vkir
冩	affr
砏	jws
楴	mead
伳	ovd
㝓	awh
䙞	aztw
㝉	at
䍆	zbdt
䄓	aku
㫶	ksad
伕	om
鈭	ofn
饤	zt
㪐	qjmx
旑	qmth
㟮	dawm
琟	uou
姏	xv
㹼	pfr
徛	pmth
翈	kiss
幆	dkfd
佱	wto
㐸	ozw
昸	kxw
䡀	idut
澋	ekqp
䢾	bos
菳	vn
䠑	jmyy
涺	ejj
䅚	pwmg
㼝	zgtq
聺	kazp
菐	pwm
鼮	frig
傒	orcm
㭦	main
晥	kayo
劆	qwso
焳	rou
昦	kmo
秹	poiy
赾	yoz
㾈	qob
庡	qqc
衜	pwky
檚	mmmo
㪍	banx
炩	rwa
袘	azv
衯	aws
窽	awfw
纮	cbc
晈	kex
叧	hs
㫿	kou
㰾	kqzw
忔	izg
㷋	rrr
䖘	ingq
忁	pkdr
炌	rwo
㬹	fzsi
盀	il
䇨	zxb
㽌	rfsq
稭	pifk
㞶	dq
欦	wazw
硹	jmwc
椀	mazg
躈	jkqx
㥆	ibr
䖼	lycs
㹍	bedj
竘	yfh
箻	zpb
㬭	krlb
㩗	bdog
眎	kyp
乛	ssss
憙	yhwe
䂚	jxx
媞	xkto
拵	bbin
蟼	vfhl
捜	bkix
漃	eaix
抪	bbd
䇶	zzf
䇏	yqhn
㴋	ebow
汘	eib
喣	hfhr
䓧	vsht
㭴	moxy
厡	tkir
䀡	kih
陥	szik
䆐	mpmp
噵	wkah
䝖	pr
蒛	vzbw
霶	reeq
衸	awo
皦	kkqx
䨲	rtdq
㹞	pz
㪛	vwdx
醕	jtqk
湥	eawm
㦏	ijjw
爎	ramp
㻱	uxba
㬟	fowk
湳	ebdy
樒	maed
䈸	zzfb
㧚	btiq
偖	oyk
㴔	ezse
㤹	ibrq
笉	zfw
襍	aoum
䐱	fedj
乢	dd
桼	mwir
豃	rhsx
螾	latw
㧱	whb
唝	hyd
靸	vlgq
澝	eaef
㝸	pko
烺	rqsc
蝅	tmtl
㟸	dkmb
礉	jkqx
聟	zmhk
嫋	xgww
兟	bobo
齅	kltm
娐	xrn
宑	av
楆	mjx
䗁	lmth
䐺	fjkb
攺	six
坵	yzt
趧	yoko
䒠	vb
䘳	an
㭿	mkfs
褞	akl
謷	ufxh
挐	xhb
砫	jqu
茣	vhtm
皽	qhhx
䐨	yatx
眿	kqsr
攌	bhlc
䖍	inx
䨕	retb
煑	ykr
袉	aaf
䦾	ihco
渃	evbh
䢚	tkxa
㚋	zzfh
隃	swfo
岯	dtit
㩥	bbon
礬	mxxj
焪	rawg
筨	zwah
疍	sokt
㳇	ewx
䍮	wuor
䍠	lqxc
珨	uwh
凮	gtk
叕	xxxx
㳀	en
橶	mbkn
䠀	jpdh
彔	jtr
㘲	yjg
辠	kyb
㞬	dy
槡	mxxm
佔	oih
槕	mikm
杅	mtb
珶	uwgi
㘃	hvbe
憜	isbf
䈘	zwcc
㭈	msw
㡽	qb
晑	kidh
䵱	lyrh
姱	xmyg
岎	dws
磟	jssp
㚧	xq
㜈	csix
㸞	zz
㡋	dml
䵗	pwil
揱	pfob
㡴	qy
㛞	xuv
窎	awgt
觃	don
躻	iduy
棢	mdwq
䀏	fk
怋	isin
嵧	dfsl
㭘	mwh
㘹	ofy
敃	sinx
媬	xohm
㤣	wve
唂	hrh
黖	lyro
鸴	eagt
襫	amtk
燋	rour
鲪	lsih
歨	oo
㽛	lfh
専	tlb
霿	rcsk
玚	ugo
弣	gob
拞	bzt
硈	jyh
䑀	fjhb
䄄	ahm
啒	hjdd
矄	kitr
愢	ile
肔	fv
岀	dd
凘	wvwz
椧	mwhs
迵	dtha
匬	swfo
堳	yjk
羳	wuil
㴭	eawk
㐓	thg
槯	mdou
㙿	ywun
䃐	jawm
瓈	upfr
㞅	nkm
㑡	oscs
瑳	uwuy
焾	rwae
萹	vqjd
䓘	vxih
靔	ufu
㵽	elll
楒	mle
䯸	upww
䄵	pb
㑂	otdw
褬	axxm
櫑	mlll
昿	kqc
垚	yyy
郋	ks
岜	djz
䓼	vxnq
毇	frgx
謩	vkmh
脺	fqwb
箙	zfsx
䢰	ssoa
㷵	rlyr
㪂	uix
拰	boiy
㙦	wmwy
唜	bwhf
鞱	vlrf
偍	okto
玈	qczc
䯋	gfbq
檽	mrtd
㚕	mgo
㤔	iob
籗	zrou
䏏	ftb
䇈	yxy
瓘	uvhu
墣	ypwm
㐡	gtdm
䃬	jdlc
莏	vbpi
俍	oqsc
杗	qm
㴂	eydy
膲	four
毀	fygx
鞶	fgxl
櫆	mlcb
棫	mnht
霱	rcsh
帗	dbxq
砄	jsw
靟	ouuu
唘	jxh
隉	sfy
䊝	rire
䕍	vqch
㜒	xfv
㕓	tlyy
䒯	vagq
昉	kq
㻏	usr
糵	vihr
腉	ffo
牕	zhxe
㓛	ys
馞	pkbn
肹	fwg
䊊	rju
䠈	jbr
㘝	hx
煵	rbdy
䢧	sswa
㑎	ocd
㒷	dwtw
陙	styc
䕂	vcha
㦻	sskn
悷	iqjm
呇	irh
奡	tkmo
䣳	jtsh
汍	egq
牣	bsq
蛠	lfff
摿	bwyk
㵡	erfj
蚖	lyo
䃻	jrvf
帠	fd
裍	ahm
粏	rmq
毣	ssu
㞜	jppx
篻	zjyp
匘	fchx
橷	mkio
謈	kvwh
尣	wo
㸺	epib
䊁	rbo
嵎	dkdq
虖	inib
堖	ychx
㢊	qmth
羬	wunh
塉	yrwf
䪃	vlqx
澸	enie
熈	isjr
瞾	kkay
鄌	qbhs
㸨	bii
㰐	msba
洨	eex
恈	icb
搾	bawy
嫹	xvlw
骯	gfqg
肁	qjb
㬆	ksik
㺵	uzw
粣	rfft
㰩	lzw
殼	yatx
愔	iyk
㽨	lwuy
嫰	xmhw
㿢	kfk
躃	jjhb
艕	feaq
㩠	bqvr
蘘	vqhc
䀌	btkl
恔	iex
踙	jkx
眓	kni
荅	vwh
㐎	qg
曤	krou
瀥	essh
腢	fkdq
臫	kd
窱	awom
煂	rvl
蕮	vffr
䪦	yky
茢	vtzo
蜟	lqcf
㛺	xyk
㳊	ex
昒	kfo
沺	el
嵠	drcm
㻧	uzbm
柟	mdy
焏	shxr
鳡	lnie
㣿	ifq
靱	vlsq
㨸	baed
坮	ych
䝉	owap
夞	zihf
侎	or
镩	nawi
氥	uj
㠖	dwun
㒋	ovwz
䨙	reiy
敧	mthx
䰯	lcfo
蕜	voue
㲁	awyx
鞨	vlkd
墾	pscy
寁	atso
潪	ezmk
麊	rqvf
䤀	jtvh
㥤	csie
䆥	awp
狏	pzv
愶	ifff
篟	zouf
㰅	meda
棸	kxm
烋	omr
㝥	azr
刏	uo
㯔	uuum
㙑	ildy
䇫	zsii
霦	rmmp
䉚	zlaq
鼜	yhwl
褽	jypc
恛	ihh
凂	wzho
䜦	gvfk
惂	izf
碀	jzsi
気	ux
㖣	hyh
琱	ufyh
䨠	rkfd
骔	gayp
抇	bk
貑	pjyx
歮	ooo
䙋	aatt
䔲	vztw
牚	pahi
狾	pbz
㑜	obz
䒥	vtd
濳	ebok
鬒	upbw
䓴	vtdm
㩐	bzyb
穼	awm
㠟	dpfr
宭	asih
媐	sihx
䑞	srrb
迠	iha
麜	qvim
㔖	fhs
烰	rrn
㔼	boub
郩	xbfs
悢	iqsc
䃝	jynx
煰	rhhh
㖬	hfx
㸳	bwa
愅	ivl
䂃	krlb
䙐	atht
㲧	uxql
瑇	uujw
硂	jwu
䃃	jdwq
枑	mtjt
蕍	vewo
䖕	ingk
䂶	jycf
茪	vpto
㣶	pqht
甀	itvq
䑎	fwwn
蟗	thil
迗	tma
㨕	bgxl
㤎	fhe
墱	yztw
㺒	pssp
洟	emg
㮬	mwcs
殔	tzbr
暠	kqhh
咶	hij
滧	eexx
㥻	nipe
潽	ewpk
筡	zwm
䋷	csip
鼸	frwp
㐇	gg
荺	vyfw
鳁	lkl
厏	tziy
㖋	wohf
䆳	awpa
霋	rtbx
丯	ippp
樃	mqsf
洃	ebr
鞂	vlp
䥣	fygn
栭	mtd
霟	revw
癚	qzth
殠	tzkm
荬	vswm
薂	vkqx
䋢	bzcp
䠸	idug
痑	qzz
壀	yjhb
䓆	vbz
䗗	lztv
兘	yoch
勊	jof
豽	pdw
塛	yjm
箇	zhj
㫑	kf
㛴	xchx
殙	tzfk
刔	swo
㩂	bzfb
柅	mjf
㷩	issr
褋	avdm
硠	jqsc
膍	fhxf
釂	jtrb
逽	vbha
憵	jhye
婃	xayp
䯯	uppi
咡	hk
峑	dwu
䍩	wux
勳	itlf
沋	enq
脀	srtf
㬔	kssp
鬄	upko
㴛	etcx
钷	nsh
䚬	zfrb
㩉	bwhs
璓	uvpg
厳	etsx
㲺	en
㓬	wmso
嬓	xkqx
玽	ufh
耓	bwt
骕	gbow
䐦	fycl
㴣	eemg
抶	bim
狅	piy
㠱	sdvw
聦	kfxe
珌	uei
䚤	zfkq
牰	bl
䂨	jzq
楢	mwjt
赨	ypl
跾	oixo
㖙	fhhf
籎	zfzo
玬	ufq
憀	issp
㲌	ug
檱	mzvw
蒑	vzsx
璥	uvfx
刜	goo
慦	brqe
狘	pni
䑰	fop
㭎	mdx
熼	rlvw
沝	irir
磀	jwda
㹩	pxy
渒	elb
梸	mpo
䐔	fqjd
㒝	ovlq
㛡	xayo
㱭	tzzx
檦	mjyo
眪	ktdw
樮	mjr
㮥	mcml
笷	zfs
肻	iaf
莦	vpf
夰	mo
䖲	lfk
䨿	tmou
杻	msy
㾑	qwh
㒔	olfl
䢁	bf
㣁	gvif
嬺	xsve
㻕	ujdd
慒	ivkk
戓	nh
㟇	dwwy
峃	ead
㶨	tir
㬑	kqhs
䔃	vak
鞛	vlyh
桳	mcmb
吶	hdw
媂	xead
奵	xt
晜	kwgi
磸	jwjm
㷛	ohmr
穙	ppwm
澯	eizr
耊	ytcy
䔟	vpzz
箟	zkif
邼	sus
棯	mwae
䜵	thwx
㣐	kirp
䇝	zn
砠	jk
嫙	xqzo
剕	ouuo
檝	mhkn
㧉	bu
喦	hhhd
萫	vpk
䒄	fatl
牨	bqg
両	tdd
怸	mqe
迼	yha
㴬	eidb
珗	ubo
㰢	tvzw
䘞	ag
㱦	tzmh
䄙	aake
洷	etcy
憉	iyhp
稈	pky
䔖	vsyx
蓃	vfix
穫	pvox
炤	rsh
嬨	xwce
镺	uim
䖪	ofl
璅	uckm
氞	utdw
䴟	qviq
䒓	vtg
㚂	ythc
㟜	dgzp
敹	iaix
嶜	dsok
㒂	ovyk
䘫	xhqc
堜	yml
忢	ue
瀷	essw
喸	bqhf
䓢	vhj
㖵	hkw
竴	ywjb
腘	fhuq
㟙	dvk
梮	mjsh
䚝	zfqb
䎪	bwkb
娮	xuh
㾩	qibf
伣	odo
㰗	mnio
㭱	mski
㛻	xmyy
壸	yatp
黳	szmr
䍒	lm
怱	fxe
嘦	hwjx
㬢	kwun
䂥	jsin
昤	kwa
貒	pdtd
㾾	qwsp
蠝	llll
䖟	ql
㣦	ppx
傂	ozig
洅	eud
偛	oibf
焻	rkk
鞀	vlsh
搫	fgxb
挬	bban
籖	zbon
昛	kss
妽	xki
㼰	lbtq
㲓	uniq
霝	rhhh
䎏	wahs
挻	biog
傋	ovdy
掍	bkif
㕵	hu
酑	jttb
嚢	thic
霤	rfsl
黇	vlwh
陾	stdm
掜	bfo
蓫	vpa
㵏	evqb
尨	npq
嗏	hvwm
㾍	qtd
㢃	qqsc
䩉	tlbq
笂	zgq
㢟	og
跥	jgm
㕼	hfxd
楅	mthl
萰	vml
曀	kyaw
䑴	fvw
剈	hfo
䀬	kwu
揃	bwfo
滵	eaed
㔨	fiyf
㴶	eaou
熴	rdkf
慴	issk
蓸	vvkk
挃	btcy
辒	bkl
囮	hof
橁	mzfk
煍	rpr
㕬	hwc
僘	opdx
㫤	kqsr
䞺	yozk
罭	lnht
䞠	yoj
螒	bkbl
䉗	zbhk
鬀	upwi
䆿	awzm
䒗	vzg
仧	iw
㞣	dws
筰	zozy
嗋	hfff
囪	hx
斾	qzd
䅓	pfhx
滣	etyh
㚐	mm
袣	avd
喖	hmj
㯢	mjjw
罤	lwgi
娽	xsir
葉	vvdm
㽒	lfiu
㯙	mqcx
傐	oqhh
䗹	lwce
㗍	hpk
侲	otyc
㻙	uqcf
倸	orm
㮡	rssm
睕	kazg
箵	zpik
㠅	dpzx
碅	jhp
蚭	ljf
秷	ptcy
淏	ektm
堓	ydty
興	zydw
箣	zmdo
磭	jtyf
懳	ibbe
嵂	dpb
䙥	arwa
㪵	wbwb
㳤	eqve
䜻	thwo
㵶	ebon
荰	vmy
炍	rzx
袇	afq
冴	wsii
㞭	md
㵪	ewuw
峟	dbf
䓋	vefn
䓞	vqjm
篖	zqbh
橏	mwuh
侤	oytg
斘	zwb
倝	bkbw
熢	rxba
㯹	mjyb
仜	oy
䞩	yowh
㓇	wim
曒	kkqx
燞	ouzr
嗺	hdou
䞱	yorh
獆	pkmb
廫	qfsp
汦	efn
㔱	sfw
僲	ojzb
淁	eyx
啿	hvwd
㳛	efw
匃	fwd
㞑	jyyd
皯	ixy
喼	hzse
㣻	xe
舃	ftgr
䟡	jfnq
煟	rlf
䝜	pcwx
䈶	zarh
皰	ixfj
㔄	jro
䏱	fjsh
敚	wjx
峱	psyd
䄌	axxx
喍	hofm
嚔	hbao
㿟	kk
燯	rrwa
㤛	ioiy
熩	rqjj
㧑	bqfq
檘	mjhb
㠨	dmxb
菋	vhbw
㽺	qgq
㫯	kkto
㹳	puh
㔍	zkvo
蝿	lkl
䔻	vqhx
梪	mthw
沯	irj
瞫	kjkb
㨇	eixb
摝	bqvf
袵	aoiy
娋	xpf
皝	kupo
馡	pkou
䁮	ksok
捥	bazg
爅	rlyy
穈	qmmp
䄨	ptb
䯶	upk
螠	lwwl
蕠	vxhp
挙	ewb
夃	gxxx
蚻	mdl
髽	upwy
㫘	tik
䈂	zwv
㧤	bqco
秞	pl
棐	ouum
刾	mwo
崨	dtso
㺬	ugq
䁼	klyy
艊	fkd
阩	siv
袐	aei
崷	dwjt
螩	loim
蹠	jqvr
㔟	iugf
㞃	rhnq
罿	lyky
踴	jcff
㢶	gtk
蒪	vbqb
㯫	minp
衧	atb
䜐	sbyh
蟵	lttb
㢱	gcp
髲	upix
癙	qfr
嬥	xssu
䧇	sqc
㚽	ytgx
窊	awc
疐	balo
㽤	lfr
㡒	dzbk
㳒	emc
搕	bycl
埰	yrm
鲃	lj
舭	fif
揦	bmho
㚠	mwur
螛	labh
䅢	plf
圵	yi
暜	yyk
篃	zjk
萢	vefj
㫊	qzth
㥓	imth
歒	edjw
䕆	vmwo
韂	vlzh
襢	aqht
狵	pnpq
㠜	dfzo
䈽	zvhu
検	mwhw
藵	vohc
㺙	pajd
㑸	ojth
揘	bku
㱂	qbrw
㛓	xxbd
㤍	ytge
箎	zing
㒐	ozfk
䘀	ihbl
薧	vqhf
㷴	tppr
稄	pcwx
奣	tmkf
哘	hpy
剬	dtdo
䌎	lxhp
簆	zayx
䟘	jqg
㼘	dtiq
廼	jg
椮	mcmp
裐	ahf
㚺	xgn
祙	abw
潎	erx
㫃	qw
䗞	tmll
岺	dwa
嬞	xviy
様	mwur
䃇	jkd
漧	ebkg
僁	oire
狣	por
䏯	fye
㗷	havd
㨀	bps
藫	vejb
䧙	sdwp
䂀	kwun
盻	kwg
僝	ojnn
宧	asii
焥	razg
簴	zinw
雂	waou
㖷	hkto
鲙	lwyc
僈	oklx
㱑	oz
㐬	qcpp
㦯	nct
獙	prx
尞	mkp
埾	kxy
䧶	oue
䰌	uppo
䈏	zthl
斏	qqsc
㧣	bbw
卶	zzs
䈥	zzff
㯐	sbym
郬	ufs
桗	mgm
䉴	zqhc
卥	ihx
倯	omwc
塱	qscy
缽	zbdt
叴	gh
怣	ime
楋	mmho
縢	fwmp
竜	ykd
㱉	pwuw
犣	bchr
㤪	tzge
㿐	qyoz
㜟	xskx
䉻	rfn
硋	jqcw
䯡	gfwp
岇	dfs
厜	tity
䧿	vkou
摏	bmf
厁	wmws
榎	mtkx
㠻	yd
癶	zzzz
塟	vtzy
㛥	xirk
巭	yfm
㠲	df
彟	sbvx
㐿	ob
扷	bim
柲	mei
䏺	fxb
捲	bwmg
豤	psc
篲	zbbs
厊	tsii
廇	qfsl
襳	awwn
諬	pnqh
秄	pn
秐	pyc
蒘	vxhb
㷇	zzbr
糦	ryhh
痠	qcwx
䯒	gfpy
衶	ahi
泭	eob
犑	bkm
㗮	zhqw
㻄	uito
䄾	pnb
跈	jwp
泤	eiqw
梂	mbrq
觙	zfgq
厓	tyy
禇	ayk
齀	kltq
㻾	qcoq
㨣	bwcs
懗	iypp
楟	mqht
㑕	odz
㒾	dyqv
礧	jlll
坄	ygx
㱜	tzo
萖	vfo
剤	qoyo
叐	ibx
㩼	zzbx
旚	qzjp
飐	gxih
焁	hzwr
囜	hc
斣	lflb
㲖	pfu
夌	ywx
愞	itdm
䉈	zvfx
㫖	ik
躰	idut
鼼	klti
踃	jpf
胟	fjw
瑺	upad
鬸	thdl
屲	id
㖮	hwd
䝂	sgxw
芠	vq
渧	eead
蛓	bln
瀫	eyax
痎	qqcw
岕	dwo
腂	fkm
犚	jypb
㲝	uou
迲	yca
劰	kf
剺	bwxs
圽	yfo
䘏	ils
稲	prik
狚	pkt
蓘	vecc
䇊	yqc
勦	ckmf
捖	bayo
䊦	ryaw
䅱	pdtw
芃	vgq
䃦	qhnj
濩	evox
獧	pltc
擑	bhkn
㺾	udh
搧	bqjs
㞿	dyx
屖	jyb
㖐	hhsi
秼	pbw
祳	atyc
跓	jqu
湢	ethl
媇	xym
郚	uhs
辤	raxb
㡸	qziy
蹽	jmkp
癓	qpdx
娷	xity
㸌	rrou
䣹	jton
铞	nhd
酨	bjtn
撆	rxb
灱	rs
䀥	kfp
㛎	xhh
篨	zswm
慁	hpe
䗐	qzvl
䣪	jttd
鄷	hvts
潟	effr
䴦	qvih
髧	upao
䰥	nhtc
犾	pm
嵹	dghl
䩦	oixl
诪	gbb
媕	xwhv
㺎	pqbf
苩	vk
蕗	vjxh
䧕	snht
貆	ptkt
湰	extu
淣	efo
㦾	qjv
㤇	iim
䄱	pq
㝨	ayhc
荎	vtcy
葾	vzge
㨞	bucp
䀓	kgq
蘍	vitf
亜	thot
䃱	jbon
溗	epif
呮	hhw
襜	azth
藒	vpkd
䗝	akil
爘	rizc
䁘	krzd
睆	kayo
黀	qmmx
踾	jthl
㷘	rchm
椙	mkk
哅	hfxd
搈	barh
澽	einp
㱷	tzom
䕲	vqqp
㼋	jc
䪬	ykbn
瓫	wstq
糛	rpay
䝐	psbf
湷	emk
斚	ccab
栤	mwir
唺	hdvw
爠	rkku
㶫	mr
埆	yzf
㗥	hqhs
瞙	kvkm
㗓	hiha
孹	jhyn
藆	vavb
毺	uwfo
熎	rrzd
歽	tzz
鼿	klto
琈	urn
撘	bzwh
朙	hwdf
禸	dccc
雴	ry
䩼	vlxa
䂿	jirk
骙	gztm
薝	vzth
佂	oto
䒎	vmvj
摨	bjib
勔	tlf
䔩	vmhx
㢬	gbc
㿱	bzix
㾚	qofy
菵	vdwq
酻	jtrn
缐	ckir
逇	yva
璂	uvwy
泏	edd
䆓	awco
鼒	bikz
蚡	lws
㿼	tvl
骽	gfrx
躍	jssu
酖	jtao
溻	ekss
墌	yqvr
噟	qooh
伈	oe
逪	vka
䏔	fsy
觵	zfvw
䯄	ghdw
鼥	frbq
堁	ykm
崥	dlb
圙	hwtl
髢	upv
躩	jkkx
鄛	ckms
䞖	yon
潱	eyaw
㭑	mbw
崅	dzf
䌸	cygq
帊	dj
邷	tigs
㜾	nwo
栶	mhm
蚄	lq
偠	ojx
䜬	rhl
浡	eban
喭	hyip
㝎	aa
俧	oye
㥁	blde
牑	zqjd
褗	askx
蛁	lsh
趽	jq
䙙	ajib
㶹	ryir
伖	obx
䑹	farx
幫	yybd
䅈	wmp
䰨	lcjk
䵥	lyrj
孶	vccn
樦	mzqu
䩳	vlax
儴	oqhc
桪	msb
蔊	vrky
䩸	vlvk
㖂	hkf
䞟	yok
圠	yd
㱣	tzrx
漜	emmy
穤	prtd
犈	bwmg
陎	sbw
妘	xyc
弎	nu
犥	bqvr
苨	vjf
䰞	gykt
䘅	cffl
阸	sqjg
璮	uqht
㗜	hqcl
隟	sckm
罻	ljyb
㗹	houe
枌	mws
罺	lckm
菙	vity
犮	bxqq
䆱	awer
翞	ssqp
㳮	ejir
掔	sxb
墚	yesm
㟢	dmth
処	xg
湚	eocf
裷	awmg
䊏	rrr
篊	zevw
翨	ssko
㠊	dinp
㳥	euv
剚	thbo
赗	ddyk
嵔	dltc
犜	bqhx
㕏	tthb
啅	hikb
䊃	rgtd
㟐	dvq
䀖	ktm
㟳	djm
葰	vocx
嵺	dssp
惉	eihe
㥢	iwjt
弞	gzw
樇	moif
溒	eyhc
垰	yitq
櫭	msct
䯿	upqb
畠	kl
䣓	thds
䙂	awce
荾	vcwx
䐟	fvdy
玣	uqi
䊘	rlf
幜	dkqp
毱	ufr
搹	btht
䥆	qoun
粅	rfo
䀺	oixk
笰	zgo
㳶	ernd
艼	vt
䩍	tlmp
揌	ble
臲	kmzg
䣜	inks
㧸	bqhs
䙢	awlk
䘥	aki
捀	bxb
柆	my
㹢	pfh
胋	fih
艠	fztw
褣	aarh
玪	uwa
挦	bsb
䏂	kfix
㳿	eqcm
褅	aead
厷	bc
㽭	lrtd
㥰	ifix
滮	einp
栚	mwm
㓀	ai
畧	lxh
㘯	yzf
䰂	uprm
爊	rqvr
簙	zbbb
婌	xipx
脨	fmh
脌	fzb
㼧	cftq
䂜	jb
啨	huf
佭	oxb
鳈	lkir
䖃	vbhh
蹅	jmkt
嵰	dwsp
呑	imh
扗	by
痽	qou
婽	xjyx
㓳	ktoo
椉	qzbm
䩔	vlgx
扴	bwo
涶	eity
舚	ijzh
孉	xvhu
崒	dqwb
㸯	bwb
㣛	pwh
㝻	vhui
鳚	ljyb
嗂	hrzd
膆	fucp
雺	rcsi
腝	ftdm
乿	rcpd
瀞	eufi
㨐	bohm
䂱	jwj
妶	xqc
㼹	vqpq
祋	agx
苢	vh
䅖	pml
䒾	vqc
枺	mbw
湩	eity
膇	fiha
㥾	isvh
椫	mwkb
蜎	lhf
溠	ewuy
皌	kbw
㵆	ekbh
铇	nfj
杤	mts
娔	xjo
䔚	vtyf
玶	uyw
㟄	dwu
㷦	krr
惐	inht
寜	aeli
㵠	eawd
嵍	csid
蠘	lbon
㧀	qjgq
粎	rjq
菧	vqfq
楺	mcsm
㘨	ydw
瑐	uwfo
嶑	dzhp
雭	rgq
蓜	vjtd
㣍	chp
宖	agc
䑧	fob
嚹	hzbb
毞	ifu
涥	eqhs
溭	elwx
拤	bii
堥	csiy
恌	ior
㛨	xwud
㜤	xjkb
淈	ejdd
扢	bzg
阣	szg
暻	kkqp
炟	rkt
峊	ihd
伬	ojq
圌	hdtd
㽷	qir
帿	dosm
㛚	xcf
䓔	vyn
澨	ezyw
䉽	rwb
㚫	xgq
䇃	yj
檏	mpww
兿	wbgc
㐘	rg
訔	duh
䲝	lwg
畃	kifq
穁	pvk
簁	zpoo
袮	azp
㭭	mhfo
艁	fbh
㨘	bpik
㙂	ywj
蒱	vbbq
杝	mv
㻁	uhh
瑝	uku
䈜	zosx
䢺	dds
勲	itkr
坕	ry
㲢	qjdu
砙	jtiq
怚	ik
䪆	vlhw
黒	kyr
㑏	oab
䭰	pkmb
蓙	vqwy
簯	zmvw
弽	gvdm
䜶	thwb
凅	whj
麍	qvip
玍	zy
䁦	kink
䎀	ssni
䋜	qjxp
捰	bkm
䯼	uppr
厀	mwis
猭	pjp
猨	pryx
堌	yhj
㙪	yyaw
䃌	jjy
礠	jwce
㞨	dn
椡	mtco
䉀	zqvr
隩	sidm
娎	bzx
㵱	ejyb
劜	fd
狔	pjf
㭄	mgb
櫂	mssu
㙻	yqky
歓	zbiw
薫	vitr
嵣	dqbh
㙞	ykm
欿	zfzw
廀	qarx
椳	mltc
侭	ojqw
歈	wfow
䀵	kczm
嫶	xour
㹬	pthx
礒	jwun
䋀	qjcp
棈	muf
捽	bqwb
虣	tong
㬍	kbqb
昄	kzx
薶	vpky
巪	sss
裚	bzqc
肗	fx
姭	fffx
歅	jyzw
䠧	jjyk
㑽	opay
庁	qt
晳	mzk
䢬	raza
䕽	vjll
豧	pbq
朸	mf
籶	rg
㢆	qky
鬿	lcz
迏	mqa
帤	xhd
珣	ufk
猇	ping
洉	ezth
猚	pou
渪	eild
乗	pv
汧	etv
䈿	zake
靫	vlxq
潃	epxf
桋	mmg
坣	pay
䅀	ptzo
曋	kjkb
䥼	nfo
偘	ohhh
俉	ouh
䀀	egl
㥋	oqce
㿇	qssk
漵	ewmx
莋	vozy
㖱	qoxh
羇	lvlh
偊	oild
邭	fhs
㭔	miwb
矤	gzm
噾	hawk
豞	pfh
牉	zwb
丗	bddd
㞘	jpq
䁃	kuc
憣	iirl
崏	dfnk
侊	opto
痃	qqc
蔨	vhwg
勼	fg
㡕	dvdm
垖	yihh
垾	yky
浻	edwh
雚	vhhu
狦	pfft
陓	smyg
筤	zqsc
虒	zing
䑫	fwv
㺠	pawc
䠄	jdvw
䒳	vgm
菓	vkm
㲅	abhx
氈	qhhu
䖷	lxbd
糆	rtl
宬	anf
䘺	aato
䯏	gfij
㭹	mgqc
丠	iyft
肵	fz
貎	pfo
㧍	bq
珱	uex
䅎	ppg
扐	bf
㞊	ddyn
廚	qyhb
褨	awuy
㖺	hmk
舏	ijii
尟	ktoi
㩱	brlb
灻	yr
骫	gfgq
蒐	vlc
獤	pqhx
昪	kcv
嗠	rnxh
侻	owj
傤	obbn
啛	htbx
㮊	mcsm
徖	payp
㧨	bzth
箰	zfkn
澏	ehhd
魀	lcwo
梕	msqe
䃯	jkrm
盠	jpl
㹉	btkp
雡	sswu
蹾	jqhx
梻	mogo
虜	inlf
鬉	upxx
塁	lry
鼪	friu
㣓	izxp
徝	pbk
㪁	waix
䘯	apf
爂	zydr
㻦	ukdq
傦	ogf
馫	pkpk
嶡	dtww
㾄	ql
笗	zxw
㽴	qtx
磑	jdtw
䥭	brqn
憕	iztw
抜	bbx
砋	jo
徏	pop
睱	kjyx
徤	pbg
㨦	boux
嵜	dyhi
荁	vtkt
䄏	avim
歺	izzz
薽	vjyq
㵦	ebya
㷕	wjtr
忴	iwa
怭	iei
蟅	lqvr
衘	pzty
偅	oity
㢜	qvle
㲚	epiu
睟	kqwb
㬼	bfzx
欪	ddzw
帀	td
嬊	vhix
臷	btcn
䁳	kvmv
仒	wwww
㓔	widb
䑿	faok
蟸	pll
㻵	ujnn
䕮	vywr
㔜	rnf
㚙	fhm
㮅	mou
㶲	rf
蚾	lix
巵	ztj
靭	vlsq
躌	jzvb
㝤	avdy
㫳	tyck
蓋	vycl
髺	upij
稩	plf
㙱	htgy
棽	mmwa
㤧	izth
敾	wuwx
䢵	ycs
㭫	mwwy
㩚	bvap
擆	bvyk
燬	rfyx
萙	vmao
凱	dthg
㪔	mmix
聥	kild
㒅	oqzc
眲	kk
䈪	ztht
丒	sqt
萜	vdih
臒	fvox
朒	fdww
㦶	ntcy
啗	hzf
袸	abin
噰	hqcu
眊	ku
廙	qlvw
拹	bfff
徢	ptso
竕	yws
㬵	fex
棞	mhp
磖	jssk
怴	ini
媌	xvl
壦	yvhu
琫	umb
辌	bqhp
悂	iify
朤	ffff
渜	etdm
乫	fhg
饳	zdd
㽐	vwsp
㡆	dqp
䐿	fidm
裯	afyh
淭	eqjm
箿	zhk
簊	zvwy
竸	ykoo
荗	vniq
羺	wurd
踷	jyk
踰	jwfo
蓤	vwyx
绬	cvdm
䩆	tlzy
㪈	yyix
㪏	lbix
荳	vthw
䎭	bwba
㡢	dkls
㣅	gsok
㧞	bibx
尃	bqbb
晄	kpto
憡	izmd
䈼	zaed
恴	qke
倖	oywy
鞟	vlqn
䄀	an
峞	dztg
蒟	vyfh
沵	ezp
焺	rkiv
䒤	vk
䓂	vuh
隣	srzb
唡	htdw
垏	yb
䖶	lp
㲫	pwmu
㴟	etkn
欋	mkku
䑭	fey
睶	kmk
㹸	pko
㼙	dtiq
羾	ssy
仠	oy
砳	jj
葁	vwux
㲴	uhi
牶	wmb
牗	zqbf
乴	bzg
䂇	csiy
昡	kqc
垈	ony
兣	joty
㭍	wnm
䠞	jnip
罱	lbdy
蒻	vgww
攐	bavc
䄿	pkf
䏑	zdww
㔊	qhho
䙨	akmc
躭	iduo
恥	ke
冋	dh
眻	kwu
䖭	wml
堻	eby
彿	pgo
涚	ewj
㟋	dwj
琽	uyk
炨	raf
吺	hgx
橗	mvkf
㾰	qjf
姀	xp
㰿	rcmw
䠶	idum
䉺	ry
㝚	aiog
屳	wd
䘚	qcb
庮	qjt
祼	akm
㲗	rnu
欼	xxxw
㙅	yhm
䆌	ppnh
滫	eoif
硥	jnpq
姉	xtd
袩	aih
沬	ebw
娪	xuh
㮏	mmyp
霑	reih
诐	gix
䯳	upwc
攈	bqvp
籊	zssu
㘊	hruh
㽚	lb
沘	eif
㸁	rpww
抲	bth
狉	ptit
剅	thwo
䨏	rwzw
䖙	sizg
䇿	zmh
霺	rpdx
蹝	jpoo
阦	sr
䐐	fpr
疌	tso
䵬	lyrk
榶	mqbh
㔓	ibf
痝	qnpq
㚵	xxw
㒠	oizt
㸓	rkkk
㣔	pt
㲾	air
峂	dxw
逳	qcfa
㶤	rz
鄊	cks
渽	ebhn
㡾	qsc
蹨	jzmr
㴧	eke
䄴	pf
赹	yofw
筁	zhv
嬚	xqwp
畆	qlc
匥	scv
㶀	efsp
邜	zs
慥	ibha
忯	ifn
䂺	jkm
琔	uato
䢑	fnqa
㳃	egb
伒	oz
㺕	pirl
㟧	dhhg
啎	zbuh
栰	mon
㙟	yqsf
㛛	xidi
鬵	sost
䆂	pqwp
㣡	pohi
笡	zk
㟝	dyh
硺	jpq
䍇	zbda
燳	rksr
圧	ty
蠎	lvmv
㸶	bhm
䍀	cozl
䰏	upbu
杄	mib
伄	ogi
嫝	xqbr
濎	ekzz
巼	jhf
䟪	jia
㴰	ecff
㲐	uwa
㴖	evl
渕	ewmo
䎦	bwrr
訚	duh
攷	tgx
晼	kazg
撡	bccp
嵙	dpwb
䣯	jtk
挿	bibk
硇	jhx
峐	dqcw
䘧	adm
靿	vlcf
䑄	fklo
㓾	jiro
䣼	jtqp
䦄	ntkc
㰦	yczw
㥨	xyye
惢	eee
掑	bvw
乹	bkbd
蝊	lato
枲	chm
䧫	sqhp
蹍	jjvc
㾥	qipx
㾷	qzig
胵	ftcy
挰	bhu
㔀	kqho
渆	ewvo
㛅	xk
㔷	stdw
峣	dnto
奝	mfyh
垬	yvw
匩	sdu
㒫	tiyo
㦔	kfme
彑	jttt
芣	vti
璄	uyko
疂	lrak
兊	wco
㜧	xtww
牬	bigi
杋	mgq
忊	it
襙	ahhm
沑	esy
捒	bmh
䅣	pku
㖝	bwhf
䑛	ijfq
忚	iv
鸻	pygt
妏	xq
霘	redh
㙌	ybow
㰉	mtcp
㥶	avwe
瑓	uml
䨖	rbf
忶	iyc
䆑	awt
䚡	zfle
䍎	zbdr
㼾	qviq
忨	iyo
琑	upf
揋	bltc
䖣	lr
惛	ifnk
㰔	muhx
栍	miu
婇	xrm
㦂	pahe
㲵	upf
䇕	yrtd
㔈	vouo
鄑	tpks
瀡	esba
䔀	vopx
徰	ptoo
沚	eo
竄	awfr
㙘	yjx
侀	otvo
䪢	igit
㝅	yatx
垳	ypy
䵎	vlwd
䇎	yvk
穮	pqvr
䂩	jhm
㓟	ixo
艶	hvtj
㰸	whww
䟳	hoss
㰞	dzw
帩	dpf
艑	fqjd
楉	mvbh
䗓	lfxe
㐴	oz
稖	pyh
墰	yjkb
旕	qwwf
凩	gm
㴑	eqwd
䖜	ingk
薓	vesx
淸	eud
洣	er
枀	wcm
㖟	hrax
㭟	vwm
㼐	qjdc
蝘	lskx
涽	efnk
酳	jtcf
霵	rhkn
䎝	yfss
䎿	kpr
堮	yhhg
睉	kwwy
狋	pyp
坹	yaw
柣	mim
䤎	jtch
㫼	kbdo
芵	vsw
篛	zgww
㡬	ccnf
镈	nbqb
熜	rhxe
㽬	thll
㬂	kkdq
躨	jwkx
㾟	qop
殹	szmx
䔑	vwmb
匊	fr
欱	whzw
䤗	ykbt
灮	ro
䎸	kuh
榑	mbqb
憯	isok
烀	riwb
㪲	wbs
㬛	kwhs
巜	cccc
窙	awyn
殏	tzbq
䕐	vatl
塶	yqvf
菼	vrr
勗	kkf
愘	iaxh
胅	fim
宼	ayox
糪	jhyr
䆞	awkf
䃙	jqvf
洬	egtz
㨴	bbkg
矷	jn
䤅	jtwo
硳	jyp
酕	jtu
醊	jtxx
鬎	upmo
郹	kms
髇	gfqh
脴	ftih
甧	iuif
䍺	wuhe
㡧	daww
嫽	xmkp
㛭	xvk
㬧	kddp
䥐	csin
硧	jcf
麖	qvip
㺱	oguq
䎅	kss
蘃	voom
鳂	lltc
䍕	lfnq
岶	dk
䨝	ruf
衁	qil
䙇	atdm
匇	fz
幥	dpab
㩿	zgx
䨶	rckz
䅁	axp
䁍	knih
坲	ygo
抃	bqi
㓧	waho
惿	ikto
襈	ajjw
愵	igww
榳	mqig
燏	rcsh
耏	tdp
脟	frb
蝲	lmho
䓰	vjy
䑢	fto
茦	vmd
㚈	zbbb
烾	rry
搰	bgf
橉	mrzb
㖨	hsir
郒	qscj
䒩	vp
䴤	qviu
恄	iyh
㣲	pdtx
㶉	erct
嫴	xjyb
擜	bbdm
㑫	owae
㑝	ouv
斔	qlfw
宍	ae
滽	eqbf
㔑	vihs
䔶	vbko
茮	vip
摣	bink
藙	vypx
甠	kiu
虇	vgvu
㝴	yob
栁	mzs
貄	pb
䢖	ba
勆	qscf
㟼	dufx
㐊	yg
䵢	lyrw
焝	rfnk
洀	ef
熣	rdou
㸈	ouor
䁴	kqht
疜	qtq
戭	atln
䑒	tcyq
悐	pre
䢄	chmm
㷼	vhir
䪩	ykwa
䤉	jtel
䇯	zk
愑	icff
㗄	hlq
憽	ivfe
诇	gdh
猉	pvw
勷	qhhf
珪	uyy
讻	gxd
醙	jtfx
㱃	wajw
㪷	thwb
遡	wdfa
䧲	you
㥏	idvw
毦	ku
猐	pwud
刅	sw
㱆	intw
橢	msbf
䏣	fk
䵾	obyx
㹥	pqu
穝	pkkx
圱	iby
葿	vjk
䕉	vlyy
櫵	mvor
蝟	llf
䏚	fpi
㶥	ry
耾	kbc
摵	bnip
㕧	hj
㤻	fqse
㯃	mmwr
㴇	irir
㮨	mlwx
㨡	bhp
㱲	tzwl
遃	yipa
㠎	doum
芛	vsi
郈	zths
燇	rwjb
藱	vqlc
㴐	ekts
涏	eiyg
踈	jmh
䞛	yots
斦	zz
匑	fidg
䆸	awzw
埊	diry
㕕	cccc
㱧	tzag
廸	lg
㝭	aiku
祰	abh
䗾	lkcr
瘉	qwfo
㐭	qhh
槜	moug
㥐	whse
卆	gbbb
䒬	vyp
䐋	fwce
粓	rv
醾	jtqr
㕌	tktb
僄	ojyp
悿	itmp
獘	rxm
菦	vza
䊌	rqif
沇	eco
帎	dao
瘜	qke
噆	hsok
䰈	upwy
㜉	xchj
㮶	mwdf
俀	orx
滐	ezbm
湁	ebwh
矁	kpre
岃	dsq
䈓	zkfd
寋	avwg
蝖	latt
饾	zthw
辵	po
泩	eiu
䅾	psok
揢	baxh
㑴	osax
歱	oity
㢕	qcou
弇	whv
剨	bjo
䧃	sl
捨	bwyh
嬏	xirl
㿭	zqix
秗	pim
磻	jirl
筙	zbw
䘋	lwwn
䶌	kltj
䉨	zypx
㼣	tktq
蒅	vegm
㼵	ktoq
椨	mqob
䗡	ltor
棁	mwj
䉌	zswp
堲	scsy
衖	pvwy
缞	cqhc
偟	oku
䏾	fmb
䇻	zju
梷	ihxm
暅	kitt
俤	owgi
剶	jpo
惌	azge
艝	frs
潊	ewmx
踥	jyx
㮯	mhp
㸫	bz
痜	qpg
擸	bchr
㵝	eqch
䞜	yoti
潛	esok
跢	jzz
珽	uiyg
㛏	xbrq
舺	fki
瓪	tigx
楥	mryx
旞	qzwa
媓	xku
㴱	eawm
橾	mhhm
䧵	aoou
蝭	lkto
觝	zffq
傇	ovk
嶕	dour
湈	evm
㙉	ydvw
䕷	vqmp
荊	vtvo
㠿	ofd
窇	awfj
㩺	iibx
㾛	qsax
俖	otih
㞾	djf
㐟	ouug
奼	xin
㧄	bd
盉	pl
㵼	eafr
肒	fgq
㚤	xn
愱	iqzm
鬽	lcp
躴	iduc
㱠	tzj
塭	ykl
㑚	osbs
䧎	shf
枒	msii
藸	vpyk
栫	mbin
梎	mkf
胨	fnp
矝	csia
葟	vku
㿑	qssu
庩	qwm
敍	wmix
柸	mtit
焆	rhf
㷢	wuyr
䟥	jcsi
胣	fzv
娳	xpo
匟	sqg
灂	erlb
畘	ldy
㞟	jwjm
椺	mohm
媡	xml
䊇	rbq
禖	avm
窪	awey
䀙	kns
㘠	hei
骴	gfof
㤮	pue
猯	pdtd
䄺	pmg
碬	jjyx
㫝	kfnq
䇑	ylb
㞢	dttt
簔	zqtc
蔳	veuf
踕	jtso
跰	jwv
㖔	htmh
芇	vd
拁	bfh
娹	xgqc
袧	afh
煉	rml
笅	zxx
棔	mfnk
滉	ekpo
囦	hir
䎋	bhss
遻	hhwa
㰻	yhww
拲	vwb
螤	qlkw
岨	dk
䃸	jwwn
㫫	ktp
䅨	ppk
茐	vfx
蜭	lzf
襆	apwm
䍙	lzjw
㚔	mwy
䨒	rss
拻	bbr
琹	uum
㺃	pvfh
䈢	zchm
䟮	jom
㱻	tzqq
䎉	ssnq
䈆	zqjm
䔿	vwjb
蓹	vpzs
竼	zgq
栄	eam
䣂	bws
蘜	vvlr
䎔	ssbb
暎	kvdm
䅭	peaq
㐚	uhg
蜶	lqwb
㫠	kwb
弨	gsh
㕹	hbxq
䒛	vcs
㾉	qwa
㫄	yfq
葍	vthl
侓	ob
蓧	voim
㥖	fqwe
㿦	yjgk
屗	jub
肟	fyg
㽖	lf
㡀	rrrr
䟁	yocm
棛	mqcf
矐	krou
睊	khf
㯝	mjxh
㠉	dyky
挒	btzo
餥	ouuc
䗳	lztw
䓬	vikb
䃑	jfgx
倣	oqx
珯	uyf
㯦	mvwm
䍄	zbdh
䈱	zrf
湺	eohm
彅	gwfs
䂆	csiq
娗	xiyg
抎	byc
矪	zmf
㕰	hu
㝛	aotw
僔	owjb
糔	rxql
㫹	kzsz
麄	wsqf
碒	jn
㻝	umho
㺨	uc
䯖	gfqc
雰	rws
杣	md
楽	krm
阭	sco
秳	pij
䔣	vpob
秚	pwb
煛	kkr
㨃	bqhn
裦	qftc
倵	oton
㻯	uinb
䧑	sato
咲	hwm
䞶	yoko
瓼	tigy
㫏	qzjx
䆻	awsx
馤	pkkd
䨋	rin
碷	jzbk
㬠	kzsr
䖒	intw
庻	qvww
䏵	fnpq
䏘	fso
䞥	yobf
䄈	athw
朿	md
暕	kml
牎	zfxe
斱	ykz
㮴	mfix
䟷	jbz
跩	jkf
芧	vcsi
㦘	kqxe
螖	lgf
厤	tpp
㨯	bqhs
穻	awtb
闬	dy
禝	alwx
趪	yovw
㳲	eemq
喠	hity
䝛	pix
冞	ar
姄	xsin
䓚	vpk
蠧	yajl
㼔	klc
摡	bsco
衑	pway
傜	orzd
禦	pztp
稒	phj
熸	rsok
䞭	yocx
叞	jypx
斺	qwo
怈	ivd
炚	kr
帟	qpd
䗬	xbal
篒	zwqc
艎	fku
襐	azhp
笐	zqg
䍋	zbdy
秥	pih
䞒	ypdh
黤	lyrl
埻	yqhn
袔	ath
忓	iy
槸	mywq
桮	mtih
懝	ifzo
䑶	fuf
蓆	vqvd
㡍	kmd
佮	owh
揔	bfxe
㦆	iinb
籹	rx
懄	ivhf
庅	qic
侷	ojsh
囼	hch
矼	jy
䏬	fcb
㰴	yhzw
䀨	kij
叾	sh
趜	yofr
庘	qki
睖	kywx
斝	hhab
熦	rpou
蠽	poul
㧕	bfs
餈	wzwc
崼	dkto
僠	oirl
矞	csih
簮	zmmk
旲	km
痶	qdvw
曺	tlk
䧜	sqbh
㢾	gjy
㵜	eeby
伨	ofw
苿	vbw
䘁	boul
袰	jwqc
丄	ittt
琋	uxbd
㠥	dlly
溎	emyy
褁	kmc
繴	jhyp
汮	efw
匲	smhh
壇	yqht
弚	wgi
彶	pgq
嬎	xzhu
甙	nvc
挷	bbs
疃	lyky
聡	kwce
隿	nou
蚲	lyw
恏	xne
挍	bex
㕊	tbq
翣	ssyx
妷	xim
䀚	kfs
榼	mycl
莻	vghf
臮	koww
䂒	zmyh
朅	yckd
犩	pxlb
朎	fwa
辺	sa
粀	rtx
㫒	kv
㳻	evk
暿	kyhh
妔	xqg
鐢	mxxn
蒬	vazq
㓲	qjdo
瀻	ebln
婐	xkm
䣏	ovws
觰	zfyk
㹰	ppto
䏆	kvkk
梑	mpr
渶	evdm
烵	rvfq
偨	oofm
䣘	pahs
倊	owce
㑨	ohzm
㧽	bhj
蜄	ltyc
碆	eixj
䟊	yoip
蕥	vsiu
豱	pkl
䀶	kqsc
璲	uwpa
朠	fvdm
熭	bbsr
㳡	eba
堷	yyk
㗽	cqsh
搒	beaq
榠	make
欜	mthc
㽟	lrb
呟	hqc
箒	zsad
屜	jpvd
䀿	kbz
䟔	ji
昘	kq
㥝	igk
娂	xvw
䩃	tlif
㚮	xag
䂠	jzm
呍	hyc
楾	mkir
亼	wt
藠	vkkk
畤	lyb
㨌	yabx
祄	awo
秌	rp
啀	htyy
扸	bz
翢	fyhs
翲	jyps
㳪	etih
慡	imxx
橖	mpam
㳍	ebd
郰	kxs
䝌	pxxx
榊	maki
溓	ewsp
䠚	jawc
礍	jvkd
㥳	itkp
拃	bziy
㽻	qbx
簝	zmkp
摖	bzyp
䩊	tlag
㠪	ti
䯨	qhdm
変	qpx
䘡	ifqc
䊬	pkmr
䩑	vlg
踳	jmk
毟	piu
栙	mxb
粨	rtk
䯚	gfcf
蹖	jmf
妋	xm
犲	pbi
婞	xywy
㣟	pyh
㵓	eako
歶	ofkq
㳆	ewb
蕀	vmdd
竧	yidi
婬	xriy
㓍	wqco
嶵	dlou
巀	dpon
陊	szz
䆪	ptoy
杶	mnd
淓	evq
鼳	frkm
棴	mfsx
旀	qcp
汵	ewa
㻈	uzth
巐	dqhv
內	dw
䣦	jtf
䆘	awki
䂮	bsj
砞	jbw
酀	vhis
犻	ptd
蔥	vhxe
㘑	hyyr
峅	dcv
㭲	mrh
䔞	vqcb
樜	mqvr
炾	rj
鄅	ilds
糑	rgww
峿	duh
剠	qhpo
寽	rb
㯚	mzwh
㕁	xbcs
褝	aekb
坈	yag
䧻	whou
㘪	yu
㟹	dkfs
怓	ixx
勮	inpf
碞	hhhj
潾	erzb
蚥	lwx
祾	aywx
柦	mkt
苶	vwp
㵂	eqvr
䃆	jvw
䶊	klty
㯲	mmmp
肀	bbbb
踺	jbg
䅶	ptyb
烢	rain
泒	ec
䗶	lvkd
䊡	rklx
镠	nssp
㿣	kkfd
幦	jhyd
䄞	azyp
㛊	xgm
苂	vr
灴	ry
䩮	vlsr
郞	qscs
垁	yzm
趆	yofq
䗙	avwl
䊕	rbg
栵	mtzo
劘	qmmo
䁔	kryx
䩪	vlah
㷱	cfyr
䜲	rhcr
毴	uouu
屶	ds
跁	jj
尫	tou
㣈	jtod
檆	mrrh
種	pity
汙	etb
㐻	odw
㱪	tzsk
労	eaf
牀	zm
汒	eq
䧧	swun
㕞	jdx
漼	edou
䁊	kxqk
㘣	hhf
湬	prir
㷔	rrik
恞	img
㗉	bsxh
媦	xlf
煭	ctzr
艀	frn
䔭	vaef
箞	zwmg
蕶	vrwa
貋	pky
㭃	mc
㨽	btho
夛	sz
邤	zs
椕	mwsm
靲	vlwa
㯈	mmha
雔	ouou
辬	ybqb
㘼	yytg
陭	smth
遯	fpa
孠	sthn
㺊	pwue
㻔	uity
桝	mzb
䵩	polr
暩	kzyp
㳗	exqy
骹	gfex
㗗	hflb
浝	enpq
罛	lc
塻	yvkm
䞿	avwo
㘽	byn
巿	td
鼡	egb
㽃	irlq
䌼	cwj
㸏	qmmr
烑	ror
泲	eigi
㺺	uk
毨	ubo
泍	emt
䐃	fhp
佸	oij
稝	pff
扚	bfq
疕	qf
㤴	ikd
峜	dwo
螁	lsca
㓡	zbdo
犠	bwun
垞	yain
䅌	phf
㢨	gy
譶	uhuh
铻	nuh
䗌	lkiu
撔	bkqp
嗙	heaq
犃	byh
敒	okix
趹	jsw
䄫	psd
䓇	vyp
畒	qlw
䴫	qvia
盿	kq
嫃	xbkw
汼	eb
淟	edvw
㣭	pxdx
痯	qah
垥	ywh
䰡	lcim
㱕	osad
螘	ldtw
䊣	rvlw
㘶	zby
踖	jvk
瑊	unih
髶	upk
堗	yawm
慼	niie
偤	owjt
筈	zij
膥	bwnw
䀇	jzbl
䠣	jjjw
㠼	dz
崀	dqsc
媴	xyhc
䟿	jsir
㽾	qdd
㠓	dvap
仯	opi
㸚	xxxx
侇	omg
䝅	py
瓥	cpll
䩷	vleq
䆟	awwh
麑	qvio
㾖	qky
螊	lwsp
䰚	thdq
埗	yop
噛	hord
螲	lawy
䒒	vst
眤	kjf
䂼	jwae
㤂	gqe
鄗	qhds
㿵	ixtm
藂	vkxp
䓵	vhhh
佪	ohh
夒	tkox
恗	imyg
